Name,Season,ThreePointers,ThreePointersAttempted,ThreePointersMissed,ThreePointersMadePct
A.J. Hammons,2017.0,5,10,5,0.5
A.J. Lawson,2023.0,10,25,15,0.4
A.J. Lawson,2024.0,12,36,24,0.3333333333333333
A.J. Price,2010.0,60,174,114,0.3448275862068966
A.J. Price,2011.0,48,165,117,0.2909090909090909
A.J. Price,2012.0,26,88,62,0.29545454545454547
A.J. Price,2013.0,70,200,130,0.35
A.J. Price,2014.0,6,22,16,0.2727272727272727
A.J. Price,2015.0,15,57,42,0.2631578947368421
AJ Green,2023.0,44,105,61,0.41904761904761906
AJ Green,2024.0,24,61,37,0.39344262295081966
AJ Griffin,2023.0,101,259,158,0.38996138996138996
AJ Griffin,2024.0,9,33,24,0.2727272727272727
Aaron Brooks,2008.0,36,119,83,0.3025210084033613
Aaron Brooks,2009.0,140,373,233,0.3753351206434316
Aaron Brooks,2010.0,209,525,316,0.3980952380952381
Aaron Brooks,2011.0,70,236,166,0.2966101694915254
Aaron Brooks,2013.0,51,143,92,0.35664335664335667
Aaron Brooks,2014.0,96,248,152,0.3870967741935484
Aaron Brooks,2015.0,129,339,210,0.3805309734513274
Aaron Brooks,2016.0,66,185,119,0.3567567567567568
Aaron Brooks,2017.0,49,130,81,0.3769230769230769
Aaron Brooks,2018.0,11,32,21,0.34375
Aaron Gordon,2015.0,13,48,35,0.2708333333333333
Aaron Gordon,2016.0,42,142,100,0.29577464788732394
Aaron Gordon,2017.0,77,266,189,0.2894736842105263
Aaron Gordon,2018.0,115,342,227,0.3362573099415205
Aaron Gordon,2019.0,129,367,238,0.35149863760217986
Aaron Gordon,2020.0,73,237,164,0.3080168776371308
Aaron Gordon,2021.0,68,199,131,0.3417085427135678
Aaron Gordon,2022.0,90,275,185,0.32727272727272727
Aaron Gordon,2023.0,78,219,141,0.3561643835616438
Aaron Gordon,2024.0,22,75,53,0.29333333333333333
Aaron Gray,2008.0,0,1,1,0.0
Aaron Gray,2009.0,0,1,1,0.0
Aaron Gray,2014.0,0,1,1,0.0
Aaron Harrison,2016.0,3,10,7,0.3
Aaron Harrison,2017.0,0,2,2,0.0
Aaron Harrison,2018.0,9,43,34,0.20930232558139536
Aaron Henry,2022.0,0,1,1,0.0
Aaron Holiday,2019.0,44,129,85,0.34108527131782945
Aaron Holiday,2020.0,91,230,139,0.39565217391304347
Aaron Holiday,2021.0,65,179,114,0.36312849162011174
Aaron Holiday,2022.0,44,110,66,0.4
Aaron Holiday,2023.0,36,88,52,0.4090909090909091
Aaron Holiday,2024.0,50,123,73,0.4065040650406504
Aaron Jackson,2018.0,1,6,5,0.16666666666666666
Aaron McKie,2004.0,73,170,97,0.4294117647058823
Aaron McKie,2005.0,21,65,44,0.3230769230769231
Aaron McKie,2006.0,0,2,2,0.0
Aaron Nesmith,2021.0,45,125,80,0.36
Aaron Nesmith,2022.0,32,126,94,0.25396825396825395
Aaron Nesmith,2023.0,115,314,199,0.3662420382165605
Aaron Nesmith,2024.0,90,199,109,0.45226130653266333
Aaron Wiggins,2022.0,42,138,96,0.30434782608695654
Aaron Wiggins,2023.0,48,122,74,0.39344262295081966
Aaron Wiggins,2024.0,27,50,23,0.54
Aaron Williams,2004.0,1,3,2,0.3333333333333333
Aaron Williams,2007.0,0,1,1,0.0
Abdel Nader,2018.0,23,69,46,0.3333333333333333
Abdel Nader,2019.0,32,100,68,0.32
Abdel Nader,2020.0,49,133,84,0.3684210526315789
Abdel Nader,2021.0,18,45,27,0.4
Abdel Nader,2022.0,4,14,10,0.2857142857142857
Acie Law,2008.0,7,34,27,0.20588235294117646
Acie Law,2009.0,10,32,22,0.3125
Acie Law,2010.0,5,16,11,0.3125
Acie Law,2011.0,6,36,30,0.16666666666666666
Adam Mokoka,2020.0,6,15,9,0.4
Adam Mokoka,2021.0,1,10,9,0.1
Adam Morrison,2007.0,87,258,171,0.3372093023255814
Adam Morrison,2009.0,32,96,64,0.3333333333333333
Adam Morrison,2010.0,5,23,18,0.21739130434782608
Adama Sanogo,2024.0,2,6,4,0.3333333333333333
Admiral Schofield,2020.0,19,60,41,0.31666666666666665
Admiral Schofield,2022.0,26,79,53,0.3291139240506329
Admiral Schofield,2023.0,24,74,50,0.32432432432432434
Admiral Schofield,2024.0,2,9,7,0.2222222222222222
Adonis Thomas,2014.0,1,5,4,0.2
Adreian Payne,2015.0,1,9,8,0.1111111111111111
Adreian Payne,2016.0,9,32,23,0.28125
Adreian Payne,2017.0,3,15,12,0.2
Adreian Payne,2018.0,2,3,1,0.6666666666666666
Adrian Griffin,2004.0,1,2,1,0.5
Adrian Griffin,2005.0,2,9,7,0.2222222222222222
Adrian Griffin,2006.0,0,2,2,0.0
Adrian Griffin,2007.0,0,6,6,0.0
Al Harrington,2004.0,23,82,59,0.2804878048780488
Al Harrington,2005.0,16,74,58,0.21621621621621623
Al Harrington,2006.0,66,188,122,0.35106382978723405
Al Harrington,2007.0,142,331,189,0.42900302114803623
Al Harrington,2008.0,153,408,255,0.375
Al Harrington,2009.0,171,470,299,0.3638297872340426
Al Harrington,2010.0,140,409,269,0.3422982885085575
Al Harrington,2011.0,122,338,216,0.3609467455621302
Al Harrington,2012.0,111,338,227,0.32840236686390534
Al Harrington,2013.0,8,30,22,0.26666666666666666
Al Harrington,2014.0,34,107,73,0.3177570093457944
Al Horford,2008.0,0,5,5,0.0
Al Horford,2009.0,0,2,2,0.0
Al Horford,2010.0,2,2,0,1.0
Al Horford,2011.0,2,6,4,0.3333333333333333
Al Horford,2012.0,0,1,1,0.0
Al Horford,2013.0,3,6,3,0.5
Al Horford,2014.0,4,11,7,0.36363636363636365
Al Horford,2015.0,13,45,32,0.28888888888888886
Al Horford,2016.0,99,284,185,0.3485915492957746
Al Horford,2017.0,113,293,180,0.3856655290102389
Al Horford,2018.0,112,269,157,0.4163568773234201
Al Horford,2019.0,91,247,156,0.3684210526315789
Al Horford,2020.0,99,287,188,0.34494773519163763
Al Horford,2021.0,56,152,96,0.3684210526315789
Al Horford,2022.0,136,363,227,0.3746556473829201
Al Horford,2023.0,173,419,246,0.4128878281622912
Al Horford,2024.0,61,149,88,0.40939597315436244
Al Jefferson,2005.0,0,3,3,0.0
Al Jefferson,2006.0,0,4,4,0.0
Al Jefferson,2007.0,0,1,1,0.0
Al Jefferson,2008.0,0,5,5,0.0
Al Jefferson,2009.0,0,4,4,0.0
Al Jefferson,2010.0,0,4,4,0.0
Al Jefferson,2012.0,1,5,4,0.2
Al Jefferson,2013.0,2,17,15,0.11764705882352941
Al Jefferson,2014.0,3,15,12,0.2
Al Jefferson,2015.0,2,5,3,0.4
Al Jefferson,2017.0,0,1,1,0.0
Al Jefferson,2018.0,0,3,3,0.0
Al Thornton,2008.0,43,130,87,0.33076923076923076
Al Thornton,2009.0,20,79,59,0.25316455696202533
Al Thornton,2010.0,11,31,20,0.3548387096774194
Al Thornton,2011.0,4,26,22,0.15384615384615385
Al-Farouq Aminu,2011.0,45,143,98,0.3146853146853147
Al-Farouq Aminu,2012.0,13,47,34,0.2765957446808511
Al-Farouq Aminu,2013.0,4,19,15,0.21052631578947367
Al-Farouq Aminu,2014.0,13,48,35,0.2708333333333333
Al-Farouq Aminu,2015.0,41,135,94,0.3037037037037037
Al-Farouq Aminu,2016.0,154,419,265,0.36754176610978523
Al-Farouq Aminu,2017.0,77,230,153,0.3347826086956522
Al-Farouq Aminu,2018.0,138,369,231,0.37398373983739835
Al-Farouq Aminu,2019.0,111,331,220,0.33534743202416917
Al-Farouq Aminu,2020.0,9,36,27,0.25
Al-Farouq Aminu,2021.0,8,37,29,0.21621621621621623
Alan Anderson,2006.0,22,54,32,0.4074074074074074
Alan Anderson,2007.0,5,20,15,0.25
Alan Anderson,2012.0,24,61,37,0.39344262295081966
Alan Anderson,2013.0,95,285,190,0.3333333333333333
Alan Anderson,2014.0,93,279,186,0.3333333333333333
Alan Anderson,2015.0,83,226,143,0.3672566371681416
Alan Anderson,2016.0,12,37,25,0.32432432432432434
Alan Anderson,2017.0,14,44,30,0.3181818181818182
Alan Henderson,2005.0,0,2,2,0.0
Alan Williams,2017.0,0,1,1,0.0
Alan Williams,2019.0,0,1,1,0.0
Alando Tucker,2008.0,1,4,3,0.25
Alando Tucker,2009.0,8,23,15,0.34782608695652173
Alando Tucker,2010.0,1,7,6,0.14285714285714285
Alec Burks,2012.0,15,47,32,0.3191489361702128
Alec Burks,2013.0,33,92,59,0.358695652173913
Alec Burks,2014.0,50,143,93,0.34965034965034963
Alec Burks,2015.0,26,68,42,0.38235294117647056
Alec Burks,2016.0,32,79,47,0.4050632911392405
Alec Burks,2017.0,25,76,51,0.32894736842105265
Alec Burks,2018.0,56,162,106,0.345679012345679
Alec Burks,2019.0,61,168,107,0.3630952380952381
Alec Burks,2020.0,119,317,198,0.3753943217665615
Alec Burks,2021.0,110,269,159,0.40892193308550184
Alec Burks,2022.0,157,389,232,0.40359897172236503
Alec Burks,2023.0,99,239,140,0.41422594142259417
Alec Burks,2024.0,91,227,136,0.4008810572687225
Alec Peters,2018.0,18,58,40,0.3103448275862069
Aleem Ford,2022.0,2,13,11,0.15384615384615385
Aleksej Pokusevski,2021.0,58,207,149,0.28019323671497587
Aleksej Pokusevski,2022.0,57,197,140,0.2893401015228426
Aleksej Pokusevski,2023.0,38,104,66,0.36538461538461536
Aleksej Pokusevski,2024.0,1,9,8,0.1111111111111111
Alen Smailagic,2020.0,3,13,10,0.23076923076923078
Alen Smailagic,2021.0,4,10,6,0.4
Alex Abrines,2017.0,99,264,165,0.375
Alex Abrines,2018.0,90,234,144,0.38461538461538464
Alex Abrines,2019.0,41,127,86,0.3228346456692913
Alex Acker,2006.0,1,5,4,0.2
Alex Acker,2009.0,7,20,13,0.35
Alex Caruso,2018.0,13,43,30,0.3023255813953488
Alex Caruso,2019.0,24,50,26,0.48
Alex Caruso,2020.0,57,181,124,0.3149171270718232
Alex Caruso,2021.0,62,157,95,0.39490445859872614
Alex Caruso,2022.0,49,145,96,0.33793103448275863
Alex Caruso,2023.0,55,151,96,0.36423841059602646
Alex Caruso,2024.0,73,176,103,0.4147727272727273
Alex Fudge,2024.0,0,2,2,0.0
Alex Garcia,2005.0,5,18,13,0.2777777777777778
Alex Len,2015.0,1,3,2,0.3333333333333333
Alex Len,2016.0,1,7,6,0.14285714285714285
Alex Len,2017.0,3,12,9,0.25
Alex Len,2018.0,1,3,2,0.3333333333333333
Alex Len,2019.0,74,204,130,0.3627450980392157
Alex Len,2020.0,16,59,43,0.2711864406779661
Alex Len,2021.0,8,25,17,0.32
Alex Len,2022.0,6,21,15,0.2857142857142857
Alex Len,2023.0,0,2,2,0.0
Alex Len,2024.0,0,2,2,0.0
Alex Poythress,2017.0,6,19,13,0.3157894736842105
Alex Poythress,2018.0,4,11,7,0.36363636363636365
Alex Poythress,2019.0,9,23,14,0.391304347826087
Alexey Shved,2013.0,85,288,203,0.2951388888888889
Alexey Shved,2014.0,30,102,72,0.29411764705882354
Alexey Shved,2015.0,47,139,92,0.3381294964028777
Alexis Ajinca,2009.0,0,2,2,0.0
Alexis Ajinca,2011.0,12,34,22,0.35294117647058826
Alexis Ajinca,2014.0,0,1,1,0.0
Alexis Ajinca,2016.0,0,1,1,0.0
Alexis Ajinca,2017.0,0,4,4,0.0
Alfonzo McKinnie,2018.0,3,9,6,0.3333333333333333
Alfonzo McKinnie,2019.0,52,150,98,0.3466666666666667
Alfonzo McKinnie,2020.0,14,65,51,0.2153846153846154
Alfonzo McKinnie,2021.0,16,41,25,0.3902439024390244
Alfonzo McKinnie,2022.0,9,27,18,0.3333333333333333
Alize Johnson,2019.0,1,2,1,0.5
Alize Johnson,2020.0,3,8,5,0.375
Alize Johnson,2021.0,1,6,5,0.16666666666666666
Alize Johnson,2022.0,0,3,3,0.0
Alize Johnson,2023.0,0,2,2,0.0
Allan Houston,2004.0,87,202,115,0.4306930693069307
Allan Houston,2005.0,31,80,49,0.3875
Allan Ray,2007.0,48,116,68,0.41379310344827586
Allen Crabbe,2014.0,6,14,8,0.42857142857142855
Allen Crabbe,2015.0,32,87,55,0.367816091954023
Allen Crabbe,2016.0,127,320,193,0.396875
Allen Crabbe,2017.0,137,315,178,0.43492063492063493
Allen Crabbe,2018.0,201,532,331,0.37781954887218044
Allen Crabbe,2019.0,98,259,161,0.3783783783783784
Allen Crabbe,2020.0,36,119,83,0.3025210084033613
Allen Iverson,2004.0,54,188,134,0.2872340425531915
Allen Iverson,2005.0,116,367,251,0.31607629427792916
Allen Iverson,2006.0,72,223,151,0.32286995515695066
Allen Iverson,2007.0,67,214,147,0.3130841121495327
Allen Iverson,2008.0,98,289,191,0.3391003460207612
Allen Iverson,2009.0,28,99,71,0.2828282828282828
Allen Iverson,2010.0,9,25,16,0.36
Allonzo Trier,2019.0,52,132,80,0.3939393939393939
Allonzo Trier,2020.0,19,53,34,0.3584905660377358
Alonzo Gee,2010.0,7,9,2,0.7777777777777778
Alonzo Gee,2011.0,17,51,34,0.3333333333333333
Alonzo Gee,2012.0,44,137,93,0.32116788321167883
Alonzo Gee,2013.0,69,219,150,0.3150684931506849
Alonzo Gee,2014.0,19,58,39,0.3275862068965517
Alonzo Gee,2015.0,13,35,22,0.37142857142857144
Alonzo Gee,2016.0,17,60,43,0.2833333333333333
Alonzo Gee,2017.0,0,3,3,0.0
Alonzo Mourning,2006.0,0,1,1,0.0
Alperen Sengun,2022.0,29,117,88,0.24786324786324787
Alperen Sengun,2023.0,19,57,38,0.3333333333333333
Alperen Sengun,2024.0,25,88,63,0.2840909090909091
Alvin Williams,2004.0,26,89,63,0.29213483146067415
Alvin Williams,2006.0,0,2,2,0.0
Alvin Williams,2007.0,0,1,1,0.0
Amal McCaskill,2004.0,0,1,1,0.0
Amar'e Stoudemire,2004.0,1,5,4,0.2
Amar'e Stoudemire,2005.0,3,19,16,0.15789473684210525
Amar'e Stoudemire,2006.0,0,1,1,0.0
Amar'e Stoudemire,2007.0,1,6,5,0.16666666666666666
Amar'e Stoudemire,2008.0,6,35,29,0.17142857142857143
Amar'e Stoudemire,2009.0,3,7,4,0.42857142857142855
Amar'e Stoudemire,2010.0,1,10,9,0.1
Amar'e Stoudemire,2011.0,10,23,13,0.43478260869565216
Amar'e Stoudemire,2012.0,5,21,16,0.23809523809523808
Amar'e Stoudemire,2013.0,1,1,0,1.0
Amar'e Stoudemire,2015.0,0,4,4,0.0
Amari Bailey,2024.0,0,2,2,0.0
Amen Thompson,2024.0,5,29,24,0.1724137931034483
Amir Coffey,2020.0,6,20,14,0.3
Amir Coffey,2021.0,24,57,33,0.42105263157894735
Amir Coffey,2022.0,96,255,159,0.3764705882352941
Amir Coffey,2023.0,11,40,29,0.275
Amir Coffey,2024.0,21,53,32,0.39622641509433965
Amir Johnson,2006.0,2,3,1,0.6666666666666666
Amir Johnson,2007.0,0,3,3,0.0
Amir Johnson,2008.0,0,1,1,0.0
Amir Johnson,2010.0,0,4,4,0.0
Amir Johnson,2011.0,0,1,1,0.0
Amir Johnson,2012.0,2,5,3,0.4
Amir Johnson,2013.0,5,13,8,0.38461538461538464
Amir Johnson,2014.0,20,68,48,0.29411764705882354
Amir Johnson,2015.0,19,47,28,0.40425531914893614
Amir Johnson,2016.0,10,45,35,0.2222222222222222
Amir Johnson,2017.0,28,69,41,0.4057971014492754
Amir Johnson,2018.0,10,32,22,0.3125
Amir Johnson,2019.0,12,40,28,0.3
Anderson Varejao,2005.0,0,2,2,0.0
Anderson Varejao,2006.0,0,1,1,0.0
Anderson Varejao,2007.0,0,13,13,0.0
Anderson Varejao,2008.0,0,2,2,0.0
Anderson Varejao,2009.0,0,2,2,0.0
Anderson Varejao,2010.0,1,6,5,0.16666666666666666
Anderson Varejao,2011.0,0,2,2,0.0
Anderson Varejao,2012.0,0,4,4,0.0
Anderson Varejao,2013.0,0,5,5,0.0
Anderson Varejao,2014.0,0,7,7,0.0
Anderson Varejao,2015.0,0,2,2,0.0
Anderson Varejao,2016.0,0,1,1,0.0
Anderson Varejao,2021.0,0,1,1,0.0
Andray Blatche,2006.0,3,13,10,0.23076923076923078
Andray Blatche,2007.0,4,27,23,0.14814814814814814
Andray Blatche,2008.0,3,14,11,0.21428571428571427
Andray Blatche,2009.0,5,21,16,0.23809523809523808
Andray Blatche,2010.0,13,44,31,0.29545454545454547
Andray Blatche,2011.0,4,18,14,0.2222222222222222
Andray Blatche,2012.0,2,7,5,0.2857142857142857
Andray Blatche,2013.0,3,22,19,0.13636363636363635
Andray Blatche,2014.0,15,56,41,0.26785714285714285
Andre Barrett,2005.0,14,52,38,0.2692307692307692
Andre Barrett,2006.0,2,14,12,0.14285714285714285
Andre Barrett,2008.0,1,3,2,0.3333333333333333
Andre Brown,2007.0,0,1,1,0.0
Andre Dawkins,2015.0,1,6,5,0.16666666666666666
Andre Drummond,2013.0,1,2,1,0.5
Andre Drummond,2014.0,0,2,2,0.0
Andre Drummond,2015.0,0,2,2,0.0
Andre Drummond,2016.0,2,7,5,0.2857142857142857
Andre Drummond,2017.0,2,7,5,0.2857142857142857
Andre Drummond,2018.0,0,11,11,0.0
Andre Drummond,2019.0,5,39,34,0.1282051282051282
Andre Drummond,2020.0,5,35,30,0.14285714285714285
Andre Drummond,2021.0,0,8,8,0.0
Andre Drummond,2022.0,0,3,3,0.0
Andre Drummond,2023.0,0,3,3,0.0
Andre Drummond,2024.0,0,2,2,0.0
Andre Emmett,2012.0,0,1,1,0.0
Andre Iguodala,2005.0,50,151,101,0.33112582781456956
Andre Iguodala,2006.0,56,158,102,0.35443037974683544
Andre Iguodala,2007.0,48,155,107,0.3096774193548387
Andre Iguodala,2008.0,103,319,216,0.322884012539185
Andre Iguodala,2009.0,91,289,198,0.314878892733564
Andre Iguodala,2010.0,94,303,209,0.3102310231023102
Andre Iguodala,2011.0,64,195,131,0.3282051282051282
Andre Iguodala,2012.0,95,242,147,0.3925619834710744
Andre Iguodala,2013.0,105,316,211,0.3322784810126582
Andre Iguodala,2014.0,70,190,120,0.3684210526315789
Andre Iguodala,2015.0,103,294,191,0.35034013605442177
Andre Iguodala,2016.0,79,219,140,0.3607305936073059
Andre Iguodala,2017.0,72,219,147,0.3287671232876712
Andre Iguodala,2018.0,47,154,107,0.3051948051948052
Andre Iguodala,2019.0,76,224,148,0.3392857142857143
Andre Iguodala,2020.0,28,86,58,0.32558139534883723
Andre Iguodala,2021.0,63,190,127,0.33157894736842103
Andre Iguodala,2022.0,18,77,59,0.23376623376623376
Andre Iguodala,2023.0,1,9,8,0.1111111111111111
Andre Ingram,2018.0,5,9,4,0.5555555555555556
Andre Ingram,2019.0,0,3,3,0.0
Andre Jackson,2024.0,13,31,18,0.41935483870967744
Andre Miller,2004.0,12,67,55,0.1791044776119403
Andre Miller,2005.0,8,43,35,0.18604651162790697
Andre Miller,2006.0,5,27,22,0.18518518518518517
Andre Miller,2007.0,5,35,30,0.14285714285714285
Andre Miller,2008.0,2,36,34,0.05555555555555555
Andre Miller,2009.0,18,63,45,0.2857142857142857
Andre Miller,2010.0,19,87,68,0.21839080459770116
Andre Miller,2011.0,8,47,39,0.1702127659574468
Andre Miller,2012.0,22,90,68,0.24444444444444444
Andre Miller,2013.0,22,75,53,0.29333333333333333
Andre Miller,2014.0,12,24,12,0.5
Andre Miller,2015.0,7,34,27,0.20588235294117646
Andre Miller,2016.0,3,11,8,0.2727272727272727
Andre Owens,2006.0,3,16,13,0.1875
Andre Owens,2008.0,18,40,22,0.45
Andre Roberson,2014.0,2,13,11,0.15384615384615385
Andre Roberson,2015.0,21,85,64,0.24705882352941178
Andre Roberson,2016.0,44,140,96,0.3142857142857143
Andre Roberson,2017.0,52,200,148,0.26
Andre Roberson,2018.0,8,36,28,0.2222222222222222
Andre Roberson,2020.0,3,15,12,0.2
Andre Roberson,2021.0,1,8,7,0.125
Andrea Bargnani,2007.0,107,285,178,0.37543859649122807
Andrea Bargnani,2008.0,94,277,183,0.33935018050541516
Andrea Bargnani,2009.0,119,291,172,0.40893470790378006
Andrea Bargnani,2010.0,121,325,204,0.3723076923076923
Andrea Bargnani,2011.0,77,223,146,0.3452914798206278
Andrea Bargnani,2012.0,34,115,81,0.2956521739130435
Andrea Bargnani,2013.0,38,123,85,0.3089430894308943
Andrea Bargnani,2014.0,30,108,78,0.2777777777777778
Andrea Bargnani,2015.0,15,41,26,0.36585365853658536
Andrea Bargnani,2016.0,3,16,13,0.1875
Andrei Kirilenko,2004.0,68,201,133,0.3383084577114428
Andrei Kirilenko,2005.0,23,77,54,0.2987012987012987
Andrei Kirilenko,2006.0,36,117,81,0.3076923076923077
Andrei Kirilenko,2007.0,19,84,65,0.2261904761904762
Andrei Kirilenko,2008.0,49,138,89,0.35507246376811596
Andrei Kirilenko,2009.0,21,78,57,0.2692307692307692
Andrei Kirilenko,2010.0,26,90,64,0.28888888888888886
Andrei Kirilenko,2011.0,36,98,62,0.3673469387755102
Andrei Kirilenko,2013.0,35,120,85,0.2916666666666667
Andrei Kirilenko,2014.0,1,5,4,0.2
Andres Nocioni,2005.0,31,114,83,0.2719298245614035
Andres Nocioni,2006.0,103,259,156,0.39768339768339767
Andres Nocioni,2007.0,93,248,155,0.375
Andres Nocioni,2008.0,126,346,220,0.36416184971098264
Andres Nocioni,2009.0,124,311,187,0.3987138263665595
Andres Nocioni,2010.0,96,249,153,0.3855421686746988
Andres Nocioni,2011.0,42,120,78,0.35
Andres Nocioni,2012.0,1,6,5,0.16666666666666666
Andrew Bogut,2006.0,0,3,3,0.0
Andrew Bogut,2007.0,1,5,4,0.2
Andrew Bogut,2008.0,0,7,7,0.0
Andrew Bogut,2010.0,0,2,2,0.0
Andrew Bogut,2011.0,0,4,4,0.0
Andrew Bogut,2012.0,0,1,1,0.0
Andrew Bogut,2013.0,1,1,0,1.0
Andrew Bogut,2015.0,0,1,1,0.0
Andrew Bogut,2016.0,1,3,2,0.3333333333333333
Andrew Bogut,2017.0,0,1,1,0.0
Andrew Bynum,2007.0,0,3,3,0.0
Andrew Bynum,2010.0,0,1,1,0.0
Andrew Bynum,2012.0,1,5,4,0.2
Andrew Goudelock,2012.0,29,76,47,0.3815789473684211
Andrew Goudelock,2013.0,2,10,8,0.2
Andrew Goudelock,2016.0,1,10,9,0.1
Andrew Harrison,2017.0,47,166,119,0.28313253012048195
Andrew Harrison,2018.0,47,142,95,0.33098591549295775
Andrew Harrison,2019.0,5,25,20,0.2
Andrew Nembhard,2023.0,92,263,171,0.34980988593155893
Andrew Nembhard,2024.0,24,71,47,0.3380281690140845
Andrew Nicholson,2014.0,28,89,61,0.3146067415730337
Andrew Nicholson,2015.0,13,41,28,0.3170731707317073
Andrew Nicholson,2016.0,41,114,73,0.35964912280701755
Andrew Nicholson,2017.0,5,27,22,0.18518518518518517
Andrew White,2018.0,18,49,31,0.3673469387755102
Andrew Wiggins,2015.0,39,126,87,0.30952380952380953
Andrew Wiggins,2016.0,57,190,133,0.3
Andrew Wiggins,2017.0,103,288,185,0.3576388888888889
Andrew Wiggins,2018.0,119,359,240,0.33147632311977715
Andrew Wiggins,2019.0,118,348,230,0.3390804597701149
Andrew Wiggins,2020.0,111,334,223,0.3323353293413174
Andrew Wiggins,2021.0,142,377,235,0.376657824933687
Andrew Wiggins,2022.0,192,504,312,0.38095238095238093
Andrew Wiggins,2023.0,108,289,181,0.3737024221453287
Andrew Wiggins,2024.0,39,126,87,0.30952380952380953
Andris Biedrins,2005.0,0,1,1,0.0
Andris Biedrins,2009.0,0,1,1,0.0
Andy Rautins,2011.0,1,4,3,0.25
Anfernee Hardaway,2004.0,35,93,58,0.3763440860215054
Anfernee Hardaway,2005.0,15,50,35,0.3
Anfernee Hardaway,2006.0,0,1,1,0.0
Anfernee Hardaway,2008.0,8,19,11,0.42105263157894735
Anfernee Simons,2019.0,10,31,21,0.3225806451612903
Anfernee Simons,2020.0,81,240,159,0.3375
Anfernee Simons,2021.0,131,299,168,0.43812709030100333
Anfernee Simons,2022.0,179,442,263,0.40497737556561086
Anfernee Simons,2023.0,212,562,350,0.37722419928825623
Anfernee Simons,2024.0,82,209,127,0.3923444976076555
Ansu Sesay,2004.0,6,21,15,0.2857142857142857
Ansu Sesay,2005.0,2,8,6,0.25
Antawn Jamison,2004.0,17,47,30,0.3617021276595745
Antawn Jamison,2005.0,88,242,154,0.36363636363636365
Antawn Jamison,2006.0,152,397,245,0.38287153652392947
Antawn Jamison,2007.0,147,405,258,0.362962962962963
Antawn Jamison,2008.0,127,379,252,0.33509234828496043
Antawn Jamison,2009.0,112,319,207,0.3510971786833856
Antawn Jamison,2010.0,95,286,191,0.3321678321678322
Antawn Jamison,2011.0,91,263,172,0.34600760456273766
Antawn Jamison,2012.0,91,267,176,0.3408239700374532
Antawn Jamison,2013.0,89,245,156,0.363265306122449
Antawn Jamison,2014.0,8,41,33,0.1951219512195122
Anthony Bennett,2014.0,13,53,40,0.24528301886792453
Anthony Bennett,2015.0,7,23,16,0.30434782608695654
Anthony Bennett,2016.0,3,14,11,0.21428571428571427
Anthony Bennett,2017.0,13,48,35,0.2708333333333333
Anthony Black,2024.0,15,48,33,0.3125
Anthony Brown,2016.0,20,70,50,0.2857142857142857
Anthony Brown,2017.0,7,27,20,0.25925925925925924
Anthony Brown,2018.0,1,1,0,1.0
Anthony Carter,2004.0,0,3,3,0.0
Anthony Carter,2005.0,2,17,15,0.11764705882352941
Anthony Carter,2006.0,4,15,11,0.26666666666666666
Anthony Carter,2007.0,0,2,2,0.0
Anthony Carter,2008.0,45,134,89,0.3358208955223881
Anthony Carter,2009.0,23,100,77,0.23
Anthony Carter,2010.0,17,63,46,0.2698412698412698
Anthony Carter,2011.0,13,43,30,0.3023255813953488
Anthony Carter,2012.0,5,17,12,0.29411764705882354
Anthony Davis,2013.0,0,6,6,0.0
Anthony Davis,2014.0,2,9,7,0.2222222222222222
Anthony Davis,2015.0,1,14,13,0.07142857142857142
Anthony Davis,2016.0,35,108,73,0.32407407407407407
Anthony Davis,2017.0,40,134,94,0.29850746268656714
Anthony Davis,2018.0,61,184,123,0.33152173913043476
Anthony Davis,2019.0,48,145,97,0.3310344827586207
Anthony Davis,2020.0,95,278,183,0.34172661870503596
Anthony Davis,2021.0,29,117,88,0.24786324786324787
Anthony Davis,2022.0,13,70,57,0.18571428571428572
Anthony Davis,2023.0,24,89,65,0.2696629213483146
Anthony Davis,2024.0,14,51,37,0.27450980392156865
Anthony Edwards,2021.0,171,520,349,0.32884615384615384
Anthony Edwards,2022.0,238,659,421,0.3611532625189681
Anthony Edwards,2023.0,228,622,394,0.3665594855305466
Anthony Edwards,2024.0,107,277,170,0.3862815884476534
Anthony Gill,2021.0,9,27,18,0.3333333333333333
Anthony Gill,2022.0,14,26,12,0.5384615384615384
Anthony Gill,2023.0,4,29,25,0.13793103448275862
Anthony Gill,2024.0,2,11,9,0.18181818181818182
Anthony Goldwire,2004.0,2,8,6,0.25
Anthony Goldwire,2005.0,32,80,48,0.4
Anthony Goldwire,2006.0,0,2,2,0.0
Anthony Grundy,2006.0,5,15,10,0.3333333333333333
Anthony Johnson,2004.0,47,142,95,0.33098591549295775
Anthony Johnson,2005.0,49,131,82,0.37404580152671757
Anthony Johnson,2006.0,59,175,116,0.33714285714285713
Anthony Johnson,2007.0,25,73,48,0.3424657534246575
Anthony Johnson,2008.0,42,93,51,0.45161290322580644
Anthony Johnson,2009.0,61,163,102,0.37423312883435583
Anthony Johnson,2010.0,13,40,27,0.325
Anthony Lamb,2021.0,21,63,42,0.3333333333333333
Anthony Lamb,2022.0,0,2,2,0.0
Anthony Lamb,2023.0,74,203,129,0.3645320197044335
Anthony Morrow,2009.0,86,184,98,0.4673913043478261
Anthony Morrow,2010.0,140,307,167,0.4560260586319218
Anthony Morrow,2011.0,110,260,150,0.4230769230769231
Anthony Morrow,2012.0,106,286,180,0.3706293706293706
Anthony Morrow,2013.0,16,43,27,0.37209302325581395
Anthony Morrow,2014.0,88,195,107,0.4512820512820513
Anthony Morrow,2015.0,141,325,184,0.4338461538461538
Anthony Morrow,2016.0,84,218,134,0.3853211009174312
Anthony Morrow,2017.0,41,133,92,0.3082706766917293
Anthony Parker,2007.0,123,281,158,0.4377224199288256
Anthony Parker,2008.0,138,321,183,0.42990654205607476
Anthony Parker,2009.0,94,241,147,0.3900414937759336
Anthony Parker,2010.0,128,305,177,0.419672131147541
Anthony Parker,2011.0,86,227,141,0.3788546255506608
Anthony Parker,2012.0,50,138,88,0.36231884057971014
Anthony Peeler,2004.0,75,167,92,0.4491017964071856
Anthony Peeler,2005.0,25,68,43,0.36764705882352944
Anthony Randolph,2009.0,0,4,4,0.0
Anthony Randolph,2010.0,1,5,4,0.2
Anthony Randolph,2011.0,1,4,3,0.25
Anthony Randolph,2012.0,0,1,1,0.0
Anthony Randolph,2013.0,0,8,8,0.0
Anthony Randolph,2014.0,18,61,43,0.29508196721311475
Anthony Roberson,2006.0,5,10,5,0.5
Anthony Roberson,2007.0,21,55,34,0.38181818181818183
Anthony Roberson,2009.0,28,83,55,0.3373493975903614
Anthony Tolliver,2009.0,9,41,32,0.21951219512195122
Anthony Tolliver,2010.0,50,152,102,0.32894736842105265
Anthony Tolliver,2011.0,47,115,68,0.40869565217391307
Anthony Tolliver,2012.0,25,101,76,0.24752475247524752
Anthony Tolliver,2013.0,52,144,92,0.3611111111111111
Anthony Tolliver,2014.0,103,249,146,0.41365461847389556
Anthony Tolliver,2015.0,106,290,184,0.36551724137931035
Anthony Tolliver,2016.0,98,274,176,0.35766423357664234
Anthony Tolliver,2017.0,90,229,139,0.3930131004366812
Anthony Tolliver,2018.0,159,365,206,0.43561643835616437
Anthony Tolliver,2019.0,81,215,134,0.3767441860465116
Anthony Tolliver,2020.0,50,147,97,0.3401360544217687
Anthony Tolliver,2021.0,4,14,10,0.2857142857142857
Antoine Walker,2004.0,78,309,231,0.2524271844660194
Antoine Walker,2005.0,117,360,243,0.325
Antoine Walker,2006.0,185,531,346,0.3483992467043315
Antoine Walker,2007.0,92,321,229,0.2866043613707165
Antoine Walker,2008.0,61,188,127,0.324468085106383
Antoine Wright,2006.0,1,15,14,0.06666666666666667
Antoine Wright,2007.0,22,65,43,0.3384615384615385
Antoine Wright,2008.0,32,110,78,0.2909090909090909
Antoine Wright,2009.0,53,170,117,0.31176470588235294
Antoine Wright,2010.0,58,173,115,0.3352601156069364
Antoine Wright,2011.0,0,4,4,0.0
Antonio Blakeney,2018.0,15,52,37,0.28846153846153844
Antonio Blakeney,2019.0,36,91,55,0.3956043956043956
Antonio Burks,2005.0,3,11,8,0.2727272727272727
Antonio Burks,2006.0,1,6,5,0.16666666666666666
Antonio Daniels,2004.0,42,116,74,0.3620689655172414
Antonio Daniels,2005.0,53,179,126,0.29608938547486036
Antonio Daniels,2006.0,26,110,84,0.23636363636363636
Antonio Daniels,2007.0,20,68,48,0.29411764705882354
Antonio Daniels,2008.0,18,78,60,0.23076923076923078
Antonio Daniels,2009.0,23,64,41,0.359375
Antonio Daniels,2011.0,0,2,2,0.0
Antonio Davis,2006.0,0,1,1,0.0
Antonio McDyess,2005.0,0,1,1,0.0
Antonio McDyess,2006.0,0,3,3,0.0
Antonio McDyess,2007.0,0,2,2,0.0
Antonio McDyess,2008.0,0,2,2,0.0
Antonio McDyess,2010.0,0,2,2,0.0
Antonio McDyess,2011.0,0,1,1,0.0
Antonius Cleveland,2018.0,3,4,1,0.75
Antonius Cleveland,2020.0,0,3,3,0.0
Anzejs Pasecniks,2020.0,0,3,3,0.0
Anzejs Pasecniks,2021.0,0,1,1,0.0
Archie Goodwin,2014.0,5,36,31,0.1388888888888889
Archie Goodwin,2015.0,12,41,29,0.2926829268292683
Archie Goodwin,2016.0,23,99,76,0.23232323232323232
Archie Goodwin,2017.0,5,15,10,0.3333333333333333
Armon Johnson,2011.0,5,12,7,0.4166666666666667
Armon Johnson,2012.0,1,3,2,0.3333333333333333
Armoni Brooks,2021.0,60,157,97,0.3821656050955414
Armoni Brooks,2022.0,74,253,179,0.2924901185770751
Armoni Brooks,2024.0,11,32,21,0.34375
Arnoldas Kulboka,2022.0,0,1,1,0.0
Aron Baynes,2013.0,0,1,1,0.0
Aron Baynes,2014.0,0,1,1,0.0
Aron Baynes,2015.0,1,4,3,0.25
Aron Baynes,2016.0,0,2,2,0.0
Aron Baynes,2018.0,14,44,30,0.3181818181818182
Aron Baynes,2019.0,23,67,44,0.34328358208955223
Aron Baynes,2020.0,59,168,109,0.35119047619047616
Aron Baynes,2021.0,27,103,76,0.2621359223300971
Arron Afflalo,2008.0,10,50,40,0.2
Arron Afflalo,2009.0,45,117,72,0.38461538461538464
Arron Afflalo,2010.0,114,263,149,0.43346007604562736
Arron Afflalo,2011.0,108,260,152,0.4153846153846154
Arron Afflalo,2012.0,92,241,149,0.3817427385892116
Arron Afflalo,2013.0,72,240,168,0.3
Arron Afflalo,2014.0,128,300,172,0.4266666666666667
Arron Afflalo,2015.0,119,337,218,0.35311572700296734
Arron Afflalo,2016.0,91,238,147,0.38235294117647056
Arron Afflalo,2017.0,62,151,89,0.4105960264900662
Arron Afflalo,2018.0,27,70,43,0.38571428571428573
Arvydas Macijauskas,2006.0,3,12,9,0.25
Ausar Thompson,2024.0,20,78,58,0.2564102564102564
Austin Croshere,2004.0,64,168,104,0.38095238095238093
Austin Croshere,2005.0,47,178,131,0.2640449438202247
Austin Croshere,2006.0,63,163,100,0.38650306748466257
Austin Croshere,2007.0,29,95,66,0.30526315789473685
Austin Croshere,2008.0,22,61,39,0.36065573770491804
Austin Croshere,2009.0,5,15,10,0.3333333333333333
Austin Daye,2010.0,29,95,66,0.30526315789473685
Austin Daye,2011.0,69,172,103,0.4011627906976744
Austin Daye,2012.0,13,62,49,0.20967741935483872
Austin Daye,2013.0,41,99,58,0.41414141414141414
Austin Daye,2014.0,12,37,25,0.32432432432432434
Austin Daye,2015.0,24,71,47,0.3380281690140845
Austin Reaves,2022.0,53,168,115,0.31547619047619047
Austin Reaves,2023.0,125,304,179,0.41118421052631576
Austin Reaves,2024.0,73,217,144,0.33640552995391704
Austin Rivers,2013.0,28,86,58,0.32558139534883723
Austin Rivers,2014.0,36,99,63,0.36363636363636365
Austin Rivers,2015.0,52,166,114,0.3132530120481928
Austin Rivers,2016.0,66,202,136,0.32673267326732675
Austin Rivers,2017.0,115,312,197,0.3685897435897436
Austin Rivers,2018.0,136,360,224,0.37777777777777777
Austin Rivers,2019.0,120,362,242,0.3314917127071823
Austin Rivers,2020.0,105,305,200,0.3442622950819672
Austin Rivers,2021.0,74,195,121,0.37948717948717947
Austin Rivers,2022.0,83,243,160,0.34156378600823045
Austin Rivers,2023.0,45,129,84,0.3488372093023256
Avery Bradley,2011.0,0,5,5,0.0
Avery Bradley,2012.0,27,76,49,0.35526315789473684
Avery Bradley,2013.0,42,134,92,0.31343283582089554
Avery Bradley,2014.0,79,200,121,0.395
Avery Bradley,2015.0,129,371,242,0.3477088948787062
Avery Bradley,2016.0,148,414,266,0.357487922705314
Avery Bradley,2017.0,148,392,244,0.37755102040816324
Avery Bradley,2018.0,75,203,128,0.3694581280788177
Avery Bradley,2019.0,86,245,159,0.3510204081632653
Avery Bradley,2020.0,63,173,110,0.36416184971098264
Avery Bradley,2021.0,33,101,68,0.32673267326732675
Avery Bradley,2022.0,82,210,128,0.3904761904761905
Avery Johnson,2004.0,0,3,3,0.0
Awvee Storey,2005.0,1,2,1,0.5
Awvee Storey,2006.0,3,7,4,0.42857142857142855
Awvee Storey,2008.0,0,7,7,0.0
Axel Toupane,2016.0,13,40,27,0.325
Axel Toupane,2017.0,1,4,3,0.25
Axel Toupane,2021.0,2,4,2,0.5
Ayo Dosunmu,2022.0,73,199,126,0.36683417085427134
Ayo Dosunmu,2023.0,59,189,130,0.31216931216931215
Ayo Dosunmu,2024.0,48,131,83,0.366412213740458
B.J. Johnson,2019.0,3,7,4,0.42857142857142855
B.J. Johnson,2020.0,4,10,6,0.4
B.J. Johnson,2022.0,4,10,6,0.4
Bam Adebayo,2018.0,0,8,8,0.0
Bam Adebayo,2019.0,3,15,12,0.2
Bam Adebayo,2020.0,2,15,13,0.13333333333333333
Bam Adebayo,2021.0,2,8,6,0.25
Bam Adebayo,2022.0,0,7,7,0.0
Bam Adebayo,2023.0,1,15,14,0.06666666666666667
Bam Adebayo,2024.0,1,11,10,0.09090909090909091
Baron Davis,2004.0,203,631,428,0.32171156893819336
Baron Davis,2005.0,118,354,236,0.3333333333333333
Baron Davis,2006.0,102,324,222,0.3148148148148148
Baron Davis,2007.0,110,347,237,0.3170028818443804
Baron Davis,2008.0,173,525,352,0.3295238095238095
Baron Davis,2009.0,99,328,229,0.3018292682926829
Baron Davis,2010.0,82,296,214,0.27702702702702703
Baron Davis,2011.0,81,239,158,0.3389121338912134
Baron Davis,2012.0,30,99,69,0.30303030303030304
Ben Bentil,2017.0,0,1,1,0.0
Ben Gordon,2005.0,141,353,212,0.39943342776203966
Ben Gordon,2006.0,180,419,239,0.4295942720763723
Ben Gordon,2007.0,179,430,251,0.41627906976744183
Ben Gordon,2008.0,142,346,204,0.41040462427745666
Ben Gordon,2009.0,190,468,278,0.405982905982906
Ben Gordon,2010.0,75,234,159,0.32051282051282054
Ben Gordon,2011.0,107,266,159,0.40225563909774437
Ben Gordon,2012.0,63,147,84,0.42857142857142855
Ben Gordon,2013.0,113,292,179,0.386986301369863
Ben Gordon,2014.0,8,29,21,0.27586206896551724
Ben Gordon,2015.0,35,97,62,0.36082474226804123
Ben Handlogten,2005.0,0,1,1,0.0
Ben Hansbrough,2013.0,6,26,20,0.23076923076923078
Ben McLemore,2014.0,95,297,202,0.31986531986531985
Ben McLemore,2015.0,140,391,251,0.35805626598465473
Ben McLemore,2016.0,67,185,118,0.3621621621621622
Ben McLemore,2017.0,65,169,104,0.38461538461538464
Ben McLemore,2018.0,55,159,104,0.34591194968553457
Ben McLemore,2019.0,17,41,24,0.4146341463414634
Ben McLemore,2020.0,195,488,293,0.39959016393442626
Ben McLemore,2021.0,99,286,187,0.34615384615384615
Ben McLemore,2022.0,151,417,266,0.36211031175059955
Ben Sheppard,2024.0,11,39,28,0.28205128205128205
Ben Simmons,2018.0,0,12,12,0.0
Ben Simmons,2019.0,0,6,6,0.0
Ben Simmons,2020.0,2,7,5,0.2857142857142857
Ben Simmons,2021.0,3,11,8,0.2727272727272727
Ben Simmons,2023.0,0,2,2,0.0
Ben Uzoh,2011.0,3,8,5,0.375
Ben Uzoh,2012.0,0,1,1,0.0
Ben Wallace,2004.0,1,11,10,0.09090909090909091
Ben Wallace,2005.0,1,13,12,0.07692307692307693
Ben Wallace,2006.0,0,5,5,0.0
Ben Wallace,2007.0,1,6,5,0.16666666666666666
Ben Wallace,2008.0,0,4,4,0.0
Ben Wallace,2010.0,0,2,2,0.0
Ben Wallace,2011.0,1,2,1,0.5
Ben Wallace,2012.0,1,4,3,0.25
Bennedict Mathurin,2023.0,100,310,210,0.3225806451612903
Bennedict Mathurin,2024.0,61,170,109,0.3588235294117647
Beno Udrih,2005.0,68,179,111,0.37988826815642457
Beno Udrih,2006.0,25,76,51,0.32894736842105265
Beno Udrih,2007.0,33,117,84,0.28205128205128205
Beno Udrih,2008.0,53,137,84,0.38686131386861317
Beno Udrih,2009.0,35,113,78,0.30973451327433627
Beno Udrih,2010.0,75,199,124,0.3768844221105528
Beno Udrih,2011.0,65,182,117,0.35714285714285715
Beno Udrih,2012.0,17,59,42,0.288135593220339
Beno Udrih,2013.0,34,102,68,0.3333333333333333
Beno Udrih,2014.0,23,54,31,0.42592592592592593
Beno Udrih,2015.0,30,113,83,0.26548672566371684
Beno Udrih,2016.0,15,44,29,0.3409090909090909
Beno Udrih,2017.0,11,32,21,0.34375
Bernard James,2013.0,0,2,2,0.0
Bernard James,2014.0,0,1,1,0.0
Bernard Robinson,2005.0,3,8,5,0.375
Bernard Robinson,2006.0,2,20,18,0.1
Bernard Robinson,2007.0,0,2,2,0.0
Bilal Coulibaly,2024.0,36,112,76,0.32142857142857145
Billy Garrett,2019.0,0,8,8,0.0
Billy Thomas,2005.0,17,56,39,0.30357142857142855
Billy Thomas,2006.0,10,34,24,0.29411764705882354
Billy Thomas,2008.0,5,18,13,0.2777777777777778
Bismack Biyombo,2016.0,0,1,1,0.0
Bismack Biyombo,2018.0,0,1,1,0.0
Bismack Biyombo,2021.0,0,1,1,0.0
Blake Ahearn,2008.0,10,34,24,0.29411764705882354
Blake Ahearn,2009.0,2,4,2,0.5
Blake Ahearn,2012.0,3,10,7,0.3
Blake Griffin,2011.0,7,24,17,0.2916666666666667
Blake Griffin,2012.0,2,17,15,0.11764705882352941
Blake Griffin,2013.0,5,28,23,0.17857142857142858
Blake Griffin,2014.0,13,51,38,0.2549019607843137
Blake Griffin,2015.0,11,32,21,0.34375
Blake Griffin,2016.0,7,20,13,0.35
Blake Griffin,2017.0,42,119,77,0.35294117647058826
Blake Griffin,2018.0,111,322,211,0.3447204968944099
Blake Griffin,2019.0,195,535,340,0.3644859813084112
Blake Griffin,2020.0,27,111,84,0.24324324324324326
Blake Griffin,2021.0,84,241,157,0.34854771784232363
Blake Griffin,2022.0,40,150,110,0.26666666666666666
Blake Griffin,2023.0,23,66,43,0.3484848484848485
Blake Wesley,2023.0,20,52,32,0.38461538461538464
Blake Wesley,2024.0,1,15,14,0.06666666666666667
Bo Outlaw,2004.0,0,4,4,0.0
Bob Sura,2004.0,21,79,58,0.26582278481012656
Bob Sura,2005.0,62,168,106,0.36904761904761907
Boban Marjanovic,2019.0,4,13,9,0.3076923076923077
Boban Marjanovic,2020.0,4,18,14,0.2222222222222222
Boban Marjanovic,2021.0,1,8,7,0.125
Boban Marjanovic,2022.0,1,4,3,0.25
Boban Marjanovic,2023.0,0,1,1,0.0
Boban Marjanovic,2024.0,0,1,1,0.0
Bobby Brown,2009.0,45,130,85,0.34615384615384615
Bobby Brown,2010.0,26,98,72,0.2653061224489796
Bobby Brown,2017.0,19,46,27,0.41304347826086957
Bobby Brown,2018.0,11,40,29,0.275
Bobby Jackson,2004.0,81,219,138,0.3698630136986301
Bobby Jackson,2005.0,36,114,78,0.3157894736842105
Bobby Jackson,2006.0,133,343,210,0.3877551020408163
Bobby Jackson,2007.0,54,165,111,0.32727272727272727
Bobby Jackson,2008.0,86,250,164,0.344
Bobby Jackson,2009.0,60,197,137,0.30456852791878175
Bobby Jones,2007.0,1,9,8,0.1111111111111111
Bobby Jones,2008.0,18,53,35,0.33962264150943394
Bobby Portis,2016.0,16,52,36,0.3076923076923077
Bobby Portis,2017.0,38,109,71,0.3486238532110092
Bobby Portis,2018.0,80,223,143,0.35874439461883406
Bobby Portis,2019.0,75,191,116,0.39267015706806285
Bobby Portis,2020.0,67,187,120,0.3582887700534759
Bobby Portis,2021.0,92,209,117,0.44019138755980863
Bobby Portis,2022.0,147,385,238,0.38181818181818183
Bobby Portis,2023.0,100,276,176,0.36231884057971014
Bobby Portis,2024.0,50,132,82,0.3787878787878788
Bobby Simmons,2004.0,2,12,10,0.16666666666666666
Bobby Simmons,2005.0,50,115,65,0.43478260869565216
Bobby Simmons,2006.0,110,262,152,0.4198473282442748
Bobby Simmons,2008.0,60,171,111,0.3508771929824561
Bobby Simmons,2009.0,117,262,145,0.44656488549618323
Bobby Simmons,2010.0,20,63,43,0.31746031746031744
Bobby Simmons,2011.0,0,3,3,0.0
Bobby Simmons,2012.0,21,64,43,0.328125
Bogdan Bogdanovic,2018.0,129,329,200,0.39209726443769
Bogdan Bogdanovic,2019.0,134,372,238,0.3602150537634409
Bogdan Bogdanovic,2020.0,164,441,277,0.37188208616780044
Bogdan Bogdanovic,2021.0,193,476,283,0.4054621848739496
Bogdan Bogdanovic,2022.0,183,495,312,0.3696969696969697
Bogdan Bogdanovic,2023.0,161,393,232,0.40966921119592875
Bogdan Bogdanovic,2024.0,137,371,234,0.3692722371967655
Bojan Bogdanovic,2015.0,102,289,187,0.35294117647058826
Bojan Bogdanovic,2016.0,129,338,209,0.3816568047337278
Bojan Bogdanovic,2017.0,160,437,277,0.36613272311212813
Bojan Bogdanovic,2018.0,172,431,259,0.3990719257540603
Bojan Bogdanovic,2019.0,171,408,237,0.41911764705882354
Bojan Bogdanovic,2020.0,189,457,268,0.4135667396061269
Bojan Bogdanovic,2021.0,215,537,322,0.40037243947858475
Bojan Bogdanovic,2022.0,192,501,309,0.38323353293413176
Bojan Bogdanovic,2023.0,145,353,208,0.41076487252124644
Bojan Bogdanovic,2024.0,75,183,108,0.4098360655737705
Bol Bol,2020.0,6,12,6,0.5
Bol Bol,2021.0,9,25,16,0.36
Bol Bol,2022.0,1,4,3,0.25
Bol Bol,2023.0,30,113,83,0.26548672566371684
Bol Bol,2024.0,3,5,2,0.6
Bones Hyland,2022.0,139,381,242,0.3648293963254593
Bones Hyland,2023.0,122,335,213,0.3641791044776119
Bones Hyland,2024.0,20,62,42,0.3225806451612903
Boniface N'Dong,2006.0,0,1,1,0.0
Bonzi Wells,2004.0,22,70,48,0.3142857142857143
Bonzi Wells,2005.0,36,104,68,0.34615384615384615
Bonzi Wells,2006.0,15,53,38,0.2830188679245283
Bonzi Wells,2007.0,1,7,6,0.14285714285714285
Bonzi Wells,2008.0,12,52,40,0.23076923076923078
Bonzie Colson,2019.0,5,21,16,0.23809523809523808
Boris Diaw,2004.0,6,26,20,0.23076923076923078
Boris Diaw,2005.0,9,50,41,0.18
Boris Diaw,2006.0,11,37,26,0.2972972972972973
Boris Diaw,2007.0,15,51,36,0.29411764705882354
Boris Diaw,2008.0,13,48,35,0.2708333333333333
Boris Diaw,2009.0,75,181,106,0.4143646408839779
Boris Diaw,2010.0,67,215,148,0.3116279069767442
Boris Diaw,2011.0,78,226,148,0.34513274336283184
Boris Diaw,2012.0,40,117,77,0.3418803418803419
Boris Diaw,2013.0,35,91,56,0.38461538461538464
Boris Diaw,2014.0,63,157,94,0.4012738853503185
Boris Diaw,2015.0,58,187,129,0.31016042780748665
Boris Diaw,2016.0,27,75,48,0.36
Boris Diaw,2017.0,26,95,69,0.2736842105263158
Bostjan Nachbar,2004.0,24,66,42,0.36363636363636365
Bostjan Nachbar,2005.0,75,196,121,0.3826530612244898
Bostjan Nachbar,2006.0,19,71,52,0.2676056338028169
Bostjan Nachbar,2007.0,130,313,183,0.41533546325878595
Bostjan Nachbar,2008.0,94,262,168,0.35877862595419846
Bracey Wright,2006.0,6,17,11,0.35294117647058826
Bracey Wright,2007.0,6,20,14,0.3
Brad Miller,2004.0,13,45,32,0.28888888888888886
Brad Miller,2005.0,5,21,16,0.23809523809523808
Brad Miller,2006.0,35,95,60,0.3684210526315789
Brad Miller,2007.0,5,33,28,0.15151515151515152
Brad Miller,2008.0,28,90,62,0.3111111111111111
Brad Miller,2009.0,28,63,35,0.4444444444444444
Brad Miller,2010.0,37,136,99,0.27205882352941174
Brad Miller,2011.0,40,107,67,0.37383177570093457
Brad Miller,2012.0,7,15,8,0.4666666666666667
Brad Wanamaker,2019.0,17,40,23,0.425
Brad Wanamaker,2020.0,49,129,80,0.3798449612403101
Brad Wanamaker,2021.0,16,85,69,0.18823529411764706
Brad Wanamaker,2022.0,4,17,13,0.23529411764705882
Bradley Beal,2013.0,91,236,145,0.3855932203389831
Bradley Beal,2014.0,160,396,236,0.40404040404040403
Bradley Beal,2015.0,129,322,193,0.40062111801242234
Bradley Beal,2016.0,105,271,166,0.3874538745387454
Bradley Beal,2017.0,252,654,402,0.3853211009174312
Bradley Beal,2018.0,220,575,355,0.3826086956521739
Bradley Beal,2019.0,209,596,387,0.35067114093959734
Bradley Beal,2020.0,170,481,311,0.35343035343035345
Bradley Beal,2021.0,142,418,276,0.3397129186602871
Bradley Beal,2022.0,63,210,147,0.3
Bradley Beal,2023.0,80,219,139,0.365296803652968
Bradley Beal,2024.0,32,89,57,0.3595505617977528
Brandan Wright,2009.0,0,4,4,0.0
Brandan Wright,2012.0,0,1,1,0.0
Brandan Wright,2013.0,0,3,3,0.0
Brandan Wright,2015.0,0,3,3,0.0
Brandan Wright,2017.0,0,1,1,0.0
Brandin Podziemski,2024.0,47,120,73,0.39166666666666666
Brandon Armstrong,2004.0,19,53,34,0.3584905660377358
Brandon Bass,2007.0,0,1,1,0.0
Brandon Bass,2008.0,0,5,5,0.0
Brandon Bass,2009.0,0,6,6,0.0
Brandon Bass,2011.0,0,2,2,0.0
Brandon Bass,2013.0,0,2,2,0.0
Brandon Bass,2014.0,2,6,4,0.3333333333333333
Brandon Bass,2015.0,9,32,23,0.28125
Brandon Bass,2016.0,0,2,2,0.0
Brandon Bass,2017.0,1,3,2,0.3333333333333333
Brandon Boston,2022.0,34,111,77,0.3063063063063063
Brandon Boston,2023.0,12,29,17,0.41379310344827586
Brandon Boston,2024.0,5,15,10,0.3333333333333333
Brandon Clarke,2020.0,27,69,42,0.391304347826087
Brandon Clarke,2021.0,20,77,57,0.2597402597402597
Brandon Clarke,2022.0,5,23,18,0.21739130434782608
Brandon Clarke,2023.0,1,6,5,0.16666666666666666
Brandon Davies,2014.0,2,10,8,0.2
Brandon Davies,2015.0,8,34,26,0.23529411764705882
Brandon Goodwin,2019.0,2,6,4,0.3333333333333333
Brandon Goodwin,2020.0,26,87,61,0.2988505747126437
Brandon Goodwin,2021.0,32,103,71,0.3106796116504854
Brandon Goodwin,2022.0,19,55,36,0.34545454545454546
Brandon Hunter,2004.0,0,3,3,0.0
Brandon Ingram,2017.0,55,187,132,0.29411764705882354
Brandon Ingram,2018.0,41,105,64,0.3904761904761905
Brandon Ingram,2019.0,31,94,63,0.32978723404255317
Brandon Ingram,2020.0,150,384,234,0.390625
Brandon Ingram,2021.0,143,375,232,0.38133333333333336
Brandon Ingram,2022.0,85,255,170,0.3333333333333333
Brandon Ingram,2023.0,64,164,100,0.3902439024390244
Brandon Ingram,2024.0,57,158,101,0.36075949367088606
Brandon Jennings,2010.0,157,429,272,0.36596736596736595
Brandon Jennings,2011.0,98,303,205,0.3234323432343234
Brandon Jennings,2012.0,129,388,259,0.3324742268041237
Brandon Jennings,2013.0,179,489,310,0.3660531697341513
Brandon Jennings,2014.0,154,457,303,0.33698030634573306
Brandon Jennings,2015.0,76,211,135,0.36018957345971564
Brandon Jennings,2016.0,51,155,104,0.32903225806451614
Brandon Jennings,2017.0,81,265,184,0.30566037735849055
Brandon Jennings,2018.0,9,35,26,0.2571428571428571
Brandon Knight,2012.0,105,276,171,0.3804347826086957
Brandon Knight,2013.0,120,327,207,0.3669724770642202
Brandon Knight,2014.0,110,338,228,0.3254437869822485
Brandon Knight,2015.0,125,321,196,0.3894080996884735
Brandon Knight,2016.0,120,351,231,0.3418803418803419
Brandon Knight,2017.0,45,139,94,0.3237410071942446
Brandon Knight,2019.0,41,129,88,0.3178294573643411
Brandon Knight,2020.0,45,131,86,0.3435114503816794
Brandon Knight,2022.0,4,17,13,0.23529411764705882
Brandon Miller,2024.0,75,188,113,0.39893617021276595
Brandon Paul,2018.0,15,54,39,0.2777777777777778
Brandon Roy,2007.0,55,146,91,0.3767123287671233
Brandon Roy,2008.0,73,215,142,0.3395348837209302
Brandon Roy,2009.0,91,237,146,0.38396624472573837
Brandon Roy,2010.0,75,233,158,0.3218884120171674
Brandon Roy,2011.0,42,128,86,0.328125
Brandon Roy,2013.0,0,9,9,0.0
Brandon Rush,2009.0,78,209,131,0.37320574162679426
Brandon Rush,2010.0,124,302,178,0.4105960264900662
Brandon Rush,2011.0,96,227,131,0.42290748898678415
Brandon Rush,2012.0,99,219,120,0.4520547945205479
Brandon Rush,2013.0,0,2,2,0.0
Brandon Rush,2014.0,16,47,31,0.3404255319148936
Brandon Rush,2015.0,4,29,25,0.13793103448275862
Brandon Rush,2016.0,69,169,100,0.40828402366863903
Brandon Rush,2017.0,44,114,70,0.38596491228070173
Brandon Sampson,2019.0,11,29,18,0.3793103448275862
Brandon Williams,2022.0,31,106,75,0.29245283018867924
Brandon Williams,2024.0,2,4,2,0.5
Braxton Key,2022.0,6,21,15,0.2857142857142857
Braxton Key,2024.0,1,4,3,0.25
Brendan Haywood,2004.0,0,1,1,0.0
Brendan Haywood,2010.0,0,1,1,0.0
Brendan Haywood,2011.0,0,1,1,0.0
Brendan Haywood,2013.0,0,1,1,0.0
Brent Barry,2004.0,114,252,138,0.4523809523809524
Brent Barry,2005.0,128,346,218,0.3699421965317919
Brent Barry,2006.0,97,236,139,0.4110169491525424
Brent Barry,2007.0,143,336,193,0.4255952380952381
Brent Barry,2008.0,67,153,86,0.43790849673202614
Brent Barry,2009.0,52,139,87,0.37410071942446044
Brevin Knight,2004.0,2,8,6,0.25
Brevin Knight,2005.0,3,20,17,0.15
Brevin Knight,2006.0,3,13,10,0.23076923076923078
Brevin Knight,2007.0,1,18,17,0.05555555555555555
Brevin Knight,2008.0,0,6,6,0.0
Brevin Knight,2009.0,0,6,6,0.0
Brian Bowen II,2020.0,0,2,2,0.0
Brian Bowen II,2021.0,0,1,1,0.0
Brian Cardinal,2004.0,55,124,69,0.4435483870967742
Brian Cardinal,2005.0,44,129,85,0.34108527131782945
Brian Cardinal,2006.0,14,31,17,0.45161290322580644
Brian Cardinal,2007.0,18,44,26,0.4090909090909091
Brian Cardinal,2008.0,25,81,56,0.30864197530864196
Brian Cardinal,2009.0,30,92,62,0.32608695652173914
Brian Cardinal,2010.0,3,9,6,0.3333333333333333
Brian Cardinal,2011.0,45,91,46,0.4945054945054945
Brian Cardinal,2012.0,11,50,39,0.22
Brian Cook,2004.0,0,5,5,0.0
Brian Cook,2005.0,78,199,121,0.39195979899497485
Brian Cook,2006.0,40,95,55,0.42105263157894735
Brian Cook,2007.0,49,122,73,0.4016393442622951
Brian Cook,2008.0,43,115,72,0.3739130434782609
Brian Cook,2009.0,15,39,24,0.38461538461538464
Brian Cook,2010.0,2,9,7,0.2222222222222222
Brian Cook,2011.0,34,79,45,0.43037974683544306
Brian Cook,2012.0,10,50,40,0.2
Brian Grant,2004.0,0,2,2,0.0
Brian Roberts,2013.0,59,153,94,0.38562091503267976
Brian Roberts,2014.0,64,178,114,0.3595505617977528
Brian Roberts,2015.0,62,193,131,0.32124352331606215
Brian Roberts,2016.0,15,46,31,0.32608695652173914
Brian Roberts,2017.0,17,44,27,0.38636363636363635
Brian Scalabrine,2004.0,15,47,32,0.3191489361702128
Brian Scalabrine,2005.0,23,72,49,0.3194444444444444
Brian Scalabrine,2006.0,31,87,56,0.3563218390804598
Brian Scalabrine,2007.0,44,110,66,0.4
Brian Scalabrine,2008.0,15,46,31,0.32608695652173914
Brian Scalabrine,2009.0,37,90,53,0.4111111111111111
Brian Scalabrine,2010.0,16,49,33,0.32653061224489793
Brian Scalabrine,2011.0,0,5,5,0.0
Brian Scalabrine,2012.0,1,7,6,0.14285714285714285
Brian Skinner,2005.0,0,1,1,0.0
Brian Skinner,2008.0,2,3,1,0.6666666666666666
Brian Skinner,2009.0,0,2,2,0.0
Briante Weber,2016.0,0,5,5,0.0
Briante Weber,2017.0,1,10,9,0.1
Briante Weber,2018.0,4,11,7,0.36363636363636365
Brice Johnson,2018.0,0,1,1,0.0
Brice Sensabaugh,2024.0,12,19,7,0.631578947368421
Britton Johnsen,2004.0,1,12,11,0.08333333333333333
Britton Johnsen,2005.0,0,4,4,0.0
Brodric Thomas,2021.0,16,59,43,0.2711864406779661
Brodric Thomas,2022.0,2,9,7,0.2222222222222222
Brook Lopez,2009.0,0,2,2,0.0
Brook Lopez,2010.0,0,2,2,0.0
Brook Lopez,2011.0,0,1,1,0.0
Brook Lopez,2013.0,1,2,1,0.5
Brook Lopez,2014.0,0,1,1,0.0
Brook Lopez,2015.0,1,10,9,0.1
Brook Lopez,2016.0,2,14,12,0.14285714285714285
Brook Lopez,2017.0,134,385,251,0.34805194805194806
Brook Lopez,2018.0,112,325,213,0.3446153846153846
Brook Lopez,2019.0,209,587,378,0.35604770017035775
Brook Lopez,2020.0,123,378,255,0.3253968253968254
Brook Lopez,2021.0,118,353,235,0.3342776203966006
Brook Lopez,2022.0,25,81,56,0.30864197530864196
Brook Lopez,2023.0,143,381,238,0.3753280839895013
Brook Lopez,2024.0,76,225,149,0.3377777777777778
Bruce Bowen,2004.0,88,241,153,0.3651452282157676
Bruce Bowen,2005.0,131,320,189,0.409375
Bruce Bowen,2006.0,119,275,156,0.43272727272727274
Bruce Bowen,2007.0,122,306,184,0.39869281045751637
Bruce Bowen,2008.0,112,269,157,0.4163568773234201
Bruce Bowen,2009.0,47,107,60,0.4392523364485981
Bruce Brown,2019.0,25,98,73,0.25510204081632654
Bruce Brown,2020.0,33,96,63,0.34375
Bruce Brown,2021.0,19,70,51,0.2714285714285714
Bruce Brown,2022.0,44,108,64,0.4074074074074074
Bruce Brown,2023.0,109,311,202,0.3504823151125402
Bruce Brown,2024.0,37,114,77,0.32456140350877194
Bruno Caboclo,2015.0,2,3,1,0.6666666666666666
Bruno Caboclo,2016.0,1,7,6,0.14285714285714285
Bruno Caboclo,2017.0,2,6,4,0.3333333333333333
Bruno Caboclo,2018.0,3,17,14,0.17647058823529413
Bruno Caboclo,2019.0,48,130,82,0.36923076923076925
Bruno Caboclo,2020.0,6,34,28,0.17647058823529413
Bruno Caboclo,2021.0,0,5,5,0.0
Bruno Fernando,2020.0,5,37,32,0.13513513513513514
Bruno Fernando,2021.0,0,2,2,0.0
Bruno Fernando,2022.0,1,2,1,0.5
Bruno Fernando,2023.0,0,4,4,0.0
Bruno Fernando,2024.0,0,3,3,0.0
Bruno Sundov,2005.0,1,3,2,0.3333333333333333
Bryce Cotton,2015.0,7,20,13,0.35
Bryce Cotton,2016.0,0,3,3,0.0
Bryce Dejean-Jones,2016.0,12,32,20,0.375
Bryce Drew,2004.0,1,7,6,0.14285714285714285
Bryce McGowens,2023.0,26,80,54,0.325
Bryce McGowens,2024.0,25,67,42,0.373134328358209
Bryn Forbes,2017.0,19,62,43,0.3064516129032258
Bryn Forbes,2018.0,91,237,146,0.38396624472573837
Bryn Forbes,2019.0,191,444,253,0.43018018018018017
Bryn Forbes,2020.0,148,381,233,0.3884514435695538
Bryn Forbes,2021.0,187,430,243,0.43488372093023253
Bryn Forbes,2022.0,126,306,180,0.4117647058823529
Bryn Forbes,2023.0,14,46,32,0.30434782608695654
Bryon Russell,2004.0,42,109,67,0.3853211009174312
Bryon Russell,2005.0,56,150,94,0.37333333333333335
Buddy Boeheim,2023.0,4,25,21,0.16
Buddy Hield,2017.0,148,379,231,0.39050131926121373
Buddy Hield,2018.0,176,408,232,0.43137254901960786
Buddy Hield,2019.0,278,651,373,0.4270353302611367
Buddy Hield,2020.0,271,688,417,0.3938953488372093
Buddy Hield,2021.0,282,721,439,0.391123439667129
Buddy Hield,2022.0,262,716,454,0.3659217877094972
Buddy Hield,2023.0,288,677,389,0.4254062038404727
Buddy Hield,2024.0,130,339,209,0.3834808259587021
Byron Mullens,2012.0,12,51,39,0.23529411764705882
Byron Mullens,2013.0,66,208,142,0.3173076923076923
Byron Mullens,2014.0,33,89,56,0.3707865168539326
C.J. McCollum,2014.0,30,85,55,0.35294117647058826
C.J. McCollum,2015.0,66,162,96,0.4074074074074074
C.J. McCollum,2016.0,217,530,313,0.40943396226415096
C.J. McCollum,2017.0,196,463,267,0.42332613390928725
C.J. McCollum,2018.0,200,502,302,0.398406374501992
C.J. McCollum,2019.0,213,562,349,0.3790035587188612
C.J. McCollum,2020.0,210,554,344,0.37906137184115524
C.J. McCollum,2021.0,183,462,279,0.3961038961038961
C.J. McCollum,2022.0,203,532,329,0.3815789473684211
C.J. McCollum,2023.0,211,544,333,0.38786764705882354
C.J. McCollum,2024.0,111,252,141,0.44047619047619047
C.J. Miles,2006.0,5,20,15,0.25
C.J. Miles,2007.0,7,32,25,0.21875
C.J. Miles,2008.0,32,85,53,0.3764705882352941
C.J. Miles,2009.0,65,187,122,0.34759358288770054
C.J. Miles,2010.0,89,263,174,0.33840304182509506
C.J. Miles,2011.0,109,339,230,0.3215339233038348
C.J. Miles,2012.0,46,150,104,0.30666666666666664
C.J. Miles,2013.0,126,328,202,0.38414634146341464
C.J. Miles,2014.0,83,211,128,0.3933649289099526
C.J. Miles,2015.0,154,446,292,0.3452914798206278
C.J. Miles,2016.0,144,407,263,0.3538083538083538
C.J. Miles,2017.0,174,425,251,0.40941176470588236
C.J. Miles,2018.0,183,499,316,0.3667334669338677
C.J. Miles,2019.0,67,203,136,0.33004926108374383
C.J. Miles,2020.0,11,35,24,0.3142857142857143
C.J. Watson,2008.0,9,26,17,0.34615384615384615
C.J. Watson,2009.0,48,120,72,0.4
C.J. Watson,2010.0,45,145,100,0.3103448275862069
C.J. Watson,2011.0,47,127,80,0.3700787401574803
C.J. Watson,2012.0,72,189,117,0.38095238095238093
C.J. Watson,2013.0,92,229,137,0.4017467248908297
C.J. Watson,2014.0,69,185,116,0.372972972972973
C.J. Watson,2015.0,70,175,105,0.4
C.J. Watson,2016.0,14,48,34,0.2916666666666667
C.J. Watson,2017.0,32,105,73,0.3047619047619048
C.J. Wilcox,2015.0,7,19,12,0.3684210526315789
C.J. Wilcox,2016.0,9,23,14,0.391304347826087
C.J. Wilcox,2017.0,3,15,12,0.2
C.J. Williams,2018.0,22,78,56,0.28205128205128205
C.J. Williams,2019.0,5,16,11,0.3125
CJ Elleby,2021.0,7,34,27,0.20588235294117646
CJ Elleby,2022.0,37,126,89,0.29365079365079366
Cade Cunningham,2022.0,114,363,249,0.3140495867768595
Cade Cunningham,2023.0,17,61,44,0.2786885245901639
Cade Cunningham,2024.0,69,203,134,0.3399014778325123
Calbert Cheaney,2004.0,0,10,10,0.0
Calbert Cheaney,2005.0,0,3,3,0.0
Calbert Cheaney,2006.0,0,8,8,0.0
Caleb Houstan,2023.0,46,136,90,0.3382352941176471
Caleb Houstan,2024.0,50,139,89,0.3597122302158273
Caleb Martin,2020.0,20,37,17,0.5405405405405406
Caleb Martin,2021.0,33,128,95,0.2578125
Caleb Martin,2022.0,74,188,114,0.39361702127659576
Caleb Martin,2023.0,128,340,212,0.3764705882352941
Caleb Martin,2024.0,36,93,57,0.3870967741935484
Caleb Swanigan,2018.0,1,9,8,0.1111111111111111
Caleb Swanigan,2019.0,1,7,6,0.14285714285714285
Caleb Swanigan,2020.0,0,2,2,0.0
Calvin Booth,2004.0,0,2,2,0.0
Calvin Booth,2005.0,0,1,1,0.0
Calvin Booth,2006.0,1,2,1,0.5
Calvin Booth,2007.0,1,2,1,0.5
Cam Whitmore,2024.0,36,88,52,0.4090909090909091
Cameron Bairstow,2016.0,1,5,4,0.2
Cameron Johnson,2020.0,106,272,166,0.3897058823529412
Cameron Johnson,2021.0,150,409,259,0.36674816625916873
Cameron Johnson,2022.0,188,450,262,0.4177777777777778
Cameron Johnson,2023.0,115,283,168,0.40636042402826855
Cameron Johnson,2024.0,88,221,133,0.39819004524886875
Cameron McGriff ,2022.0,2,6,4,0.3333333333333333
Cameron Oliver,2021.0,4,13,9,0.3076923076923077
Cameron Oliver,2022.0,1,3,2,0.3333333333333333
Cameron Payne,2016.0,38,121,83,0.3140495867768595
Cameron Payne,2017.0,28,87,59,0.3218390804597701
Cameron Payne,2018.0,35,91,56,0.38461538461538464
Cameron Payne,2019.0,25,84,59,0.2976190476190476
Cameron Payne,2020.0,15,29,14,0.5172413793103449
Cameron Payne,2021.0,98,235,137,0.41702127659574467
Cameron Payne,2022.0,76,241,165,0.3153526970954357
Cameron Payne,2023.0,79,212,133,0.37264150943396224
Cameron Payne,2024.0,49,120,71,0.4083333333333333
Cameron Reddish,2020.0,83,250,167,0.332
Cameron Reddish,2021.0,42,140,98,0.3
Cameron Reddish,2022.0,66,184,118,0.358695652173913
Cameron Reddish,2023.0,45,144,99,0.3125
Cameron Reddish,2024.0,33,98,65,0.336734693877551
Cameron Reynolds,2019.0,21,51,30,0.4117647058823529
Cameron Reynolds,2021.0,3,12,9,0.25
Cameron Thomas,2022.0,47,174,127,0.27011494252873564
Cameron Thomas,2023.0,51,135,84,0.37777777777777777
Cameron Thomas,2024.0,68,195,127,0.3487179487179487
Caris LeVert,2017.0,57,180,123,0.31666666666666665
Caris LeVert,2018.0,85,245,160,0.3469387755102041
Caris LeVert,2019.0,60,180,120,0.3333333333333333
Caris LeVert,2020.0,89,241,152,0.36929460580912865
Caris LeVert,2021.0,84,258,174,0.32558139534883723
Caris LeVert,2022.0,86,265,179,0.32452830188679244
Caris LeVert,2023.0,140,360,220,0.3888888888888889
Caris LeVert,2024.0,63,184,121,0.3423913043478261
Carl Landry,2008.0,0,1,1,0.0
Carl Landry,2009.0,1,5,4,0.2
Carl Landry,2010.0,1,3,2,0.3333333333333333
Carl Landry,2011.0,0,4,4,0.0
Carl Landry,2012.0,0,3,3,0.0
Carl Landry,2013.0,1,3,2,0.3333333333333333
Carl Landry,2016.0,6,13,7,0.46153846153846156
Carldell Johnson,2012.0,4,15,11,0.26666666666666666
Carlik Jones,2022.0,0,1,1,0.0
Carlik Jones,2023.0,3,6,3,0.5
Carlos Arroyo,2004.0,38,117,79,0.3247863247863248
Carlos Arroyo,2005.0,8,31,23,0.25806451612903225
Carlos Arroyo,2006.0,7,20,13,0.35
Carlos Arroyo,2007.0,14,53,39,0.2641509433962264
Carlos Arroyo,2008.0,29,85,56,0.3411764705882353
Carlos Arroyo,2010.0,7,26,19,0.2692307692307692
Carlos Arroyo,2011.0,31,69,38,0.4492753623188406
Carlos Boozer,2004.0,1,6,5,0.16666666666666666
Carlos Boozer,2005.0,0,1,1,0.0
Carlos Boozer,2008.0,0,1,1,0.0
Carlos Boozer,2011.0,0,1,1,0.0
Carlos Boozer,2012.0,0,1,1,0.0
Carlos Boozer,2013.0,0,3,3,0.0
Carlos Boozer,2014.0,0,2,2,0.0
Carlos Delfino,2005.0,9,35,26,0.2571428571428571
Carlos Delfino,2006.0,21,62,41,0.3387096774193548
Carlos Delfino,2007.0,49,154,105,0.3181818181818182
Carlos Delfino,2008.0,124,329,205,0.3768996960486322
Carlos Delfino,2010.0,149,402,253,0.3706467661691542
Carlos Delfino,2011.0,105,284,179,0.36971830985915494
Carlos Delfino,2012.0,86,239,153,0.3598326359832636
Carlos Delfino,2013.0,169,452,283,0.37389380530973454
Carmelo Anthony,2004.0,71,225,154,0.31555555555555553
Carmelo Anthony,2005.0,42,159,117,0.2641509433962264
Carmelo Anthony,2006.0,37,156,119,0.23717948717948717
Carmelo Anthony,2007.0,49,167,118,0.2934131736526946
Carmelo Anthony,2008.0,60,172,112,0.3488372093023256
Carmelo Anthony,2009.0,87,236,149,0.3686440677966102
Carmelo Anthony,2010.0,65,206,141,0.3155339805825243
Carmelo Anthony,2011.0,104,277,173,0.37545126353790614
Carmelo Anthony,2012.0,72,221,149,0.3257918552036199
Carmelo Anthony,2013.0,174,471,297,0.36942675159235666
Carmelo Anthony,2014.0,167,415,248,0.40240963855421685
Carmelo Anthony,2015.0,61,179,118,0.3407821229050279
Carmelo Anthony,2016.0,105,310,205,0.3387096774193548
Carmelo Anthony,2017.0,151,420,269,0.3595238095238095
Carmelo Anthony,2018.0,175,502,327,0.34860557768924305
Carmelo Anthony,2019.0,21,64,43,0.328125
Carmelo Anthony,2020.0,96,251,155,0.38247011952191234
Carmelo Anthony,2021.0,147,362,215,0.40607734806629836
Carmelo Anthony,2022.0,149,397,248,0.37531486146095716
Caron Butler,2004.0,12,53,41,0.22641509433962265
Caron Butler,2005.0,38,125,87,0.304
Caron Butler,2006.0,44,133,89,0.3308270676691729
Caron Butler,2007.0,18,72,54,0.25
Caron Butler,2008.0,71,206,135,0.3446601941747573
Caron Butler,2009.0,65,210,145,0.30952380952380953
Caron Butler,2010.0,49,168,119,0.2916666666666667
Caron Butler,2011.0,28,65,37,0.4307692307692308
Caron Butler,2012.0,100,288,188,0.3472222222222222
Caron Butler,2013.0,132,346,214,0.3815028901734104
Caron Butler,2014.0,119,308,189,0.38636363636363635
Caron Butler,2015.0,83,219,136,0.3789954337899543
Caron Butler,2016.0,3,18,15,0.16666666666666666
Carrick Felix,2014.0,2,5,3,0.4
Carsen Edwards,2020.0,24,76,52,0.3157894736842105
Carsen Edwards,2021.0,19,66,47,0.2878787878787879
Carsen Edwards,2022.0,4,16,12,0.25
Cartier Martin,2009.0,10,33,23,0.30303030303030304
Cartier Martin,2010.0,17,49,32,0.3469387755102041
Cartier Martin,2011.0,39,99,60,0.3939393939393939
Cartier Martin,2012.0,29,75,46,0.38666666666666666
Cartier Martin,2013.0,58,146,88,0.3972602739726027
Cartier Martin,2014.0,59,151,92,0.39072847682119205
Cartier Martin,2015.0,6,33,27,0.18181818181818182
Casey Jacobsen,2004.0,75,180,105,0.4166666666666667
Casey Jacobsen,2005.0,66,177,111,0.3728813559322034
Casey Jacobsen,2008.0,16,72,56,0.2222222222222222
Cason Wallace,2024.0,48,116,68,0.41379310344827586
Casper Ware,2014.0,7,21,14,0.3333333333333333
Cassius Stanley,2021.0,4,16,12,0.25
Cassius Stanley,2022.0,4,17,13,0.23529411764705882
Cassius Winston,2021.0,8,19,11,0.42105263157894735
Cassius Winston,2022.0,2,6,4,0.3333333333333333
Cedi Osman,2018.0,33,94,61,0.35106382978723405
Cedi Osman,2019.0,130,374,244,0.34759358288770054
Cedi Osman,2020.0,123,321,198,0.38317757009345793
Cedi Osman,2021.0,99,324,225,0.3055555555555556
Cedi Osman,2022.0,128,359,231,0.3565459610027855
Cedi Osman,2023.0,122,332,210,0.3674698795180723
Cedi Osman,2024.0,51,141,90,0.3617021276595745
Cedric Bozeman,2007.0,2,13,11,0.15384615384615385
Cedric Jackson,2010.0,1,6,5,0.16666666666666666
Chandler Hutchison,2019.0,14,50,36,0.28
Chandler Hutchison,2020.0,12,38,26,0.3157894736842105
Chandler Hutchison,2021.0,8,22,14,0.36363636363636365
Chandler Parsons,2012.0,60,178,118,0.33707865168539325
Chandler Parsons,2013.0,168,435,267,0.38620689655172413
Chandler Parsons,2014.0,143,387,244,0.3695090439276486
Chandler Parsons,2015.0,132,351,219,0.37606837606837606
Chandler Parsons,2016.0,104,251,147,0.41434262948207173
Chandler Parsons,2017.0,23,90,67,0.25555555555555554
Chandler Parsons,2018.0,51,121,70,0.4214876033057851
Chandler Parsons,2019.0,29,94,65,0.30851063829787234
Chandler Parsons,2020.0,4,14,10,0.2857142857142857
Channing Frye,2006.0,3,9,6,0.3333333333333333
Channing Frye,2007.0,3,18,15,0.16666666666666666
Channing Frye,2008.0,3,10,7,0.3
Channing Frye,2009.0,11,33,22,0.3333333333333333
Channing Frye,2010.0,202,478,276,0.4225941422594142
Channing Frye,2011.0,171,439,268,0.3895216400911162
Channing Frye,2012.0,91,263,172,0.34600760456273766
Channing Frye,2014.0,160,432,272,0.37037037037037035
Channing Frye,2015.0,136,346,210,0.3930635838150289
Channing Frye,2016.0,117,281,164,0.41637010676156583
Channing Frye,2017.0,157,373,216,0.42091152815013405
Channing Frye,2018.0,39,115,76,0.3391304347826087
Channing Frye,2019.0,32,79,47,0.4050632911392405
Charles Bassey,2022.0,0,4,4,0.0
Charles Bassey,2023.0,3,8,5,0.375
Charles Bassey,2024.0,0,1,1,0.0
Charles Bediako,2024.0,3,11,8,0.2727272727272727
Charles Cooke,2018.0,1,8,7,0.125
Charles Jenkins,2012.0,3,20,17,0.15
Charles Jenkins,2013.0,1,2,1,0.5
Charles Smith,2006.0,15,38,23,0.39473684210526316
Charlie Bell,2006.0,76,179,103,0.4245810055865922
Charlie Bell,2007.0,127,361,234,0.3518005540166205
Charlie Bell,2008.0,74,217,143,0.34101382488479265
Charlie Bell,2009.0,87,240,153,0.3625
Charlie Bell,2010.0,73,201,128,0.36318407960199006
Charlie Bell,2011.0,6,21,15,0.2857142857142857
Charlie Brown,2020.0,3,9,6,0.3333333333333333
Charlie Brown,2021.0,5,21,16,0.23809523809523808
Charlie Brown,2022.0,1,12,11,0.08333333333333333
Charlie Brown,2024.0,1,3,2,0.3333333333333333
Charlie Villanueva,2006.0,70,214,144,0.32710280373831774
Charlie Villanueva,2007.0,29,86,57,0.3372093023255814
Charlie Villanueva,2008.0,55,185,130,0.2972972972972973
Charlie Villanueva,2009.0,89,258,169,0.3449612403100775
Charlie Villanueva,2010.0,99,282,183,0.35106382978723405
Charlie Villanueva,2011.0,125,323,198,0.38699690402476783
Charlie Villanueva,2012.0,15,45,30,0.3333333333333333
Charlie Villanueva,2013.0,90,259,169,0.3474903474903475
Charlie Villanueva,2014.0,14,56,42,0.25
Charlie Villanueva,2015.0,91,240,149,0.37916666666666665
Charlie Villanueva,2016.0,48,177,129,0.2711864406779661
Charlie Ward,2004.0,87,209,122,0.41626794258373206
Charlie Ward,2005.0,16,51,35,0.3137254901960784
Chase Budinger,2010.0,92,249,157,0.36947791164658633
Chase Budinger,2011.0,89,274,185,0.3248175182481752
Chase Budinger,2012.0,88,219,131,0.4018264840182648
Chase Budinger,2013.0,26,81,55,0.32098765432098764
Chase Budinger,2014.0,42,120,78,0.35
Chase Budinger,2015.0,52,143,91,0.36363636363636365
Chase Budinger,2016.0,24,86,62,0.27906976744186046
Chasson Randle,2017.0,16,47,31,0.3404255319148936
Chasson Randle,2019.0,46,115,69,0.4
Chasson Randle,2020.0,0,2,2,0.0
Chasson Randle,2021.0,44,130,86,0.3384615384615385
Chauncey Billups,2004.0,167,442,275,0.3778280542986425
Chauncey Billups,2005.0,209,513,304,0.4074074074074074
Chauncey Billups,2006.0,216,519,303,0.4161849710982659
Chauncey Billups,2007.0,144,406,262,0.35467980295566504
Chauncey Billups,2008.0,161,406,245,0.39655172413793105
Chauncey Billups,2009.0,206,491,285,0.4195519348268839
Chauncey Billups,2010.0,168,438,270,0.3835616438356164
Chauncey Billups,2011.0,148,369,221,0.4010840108401084
Chauncey Billups,2012.0,48,125,77,0.384
Chauncey Billups,2013.0,39,107,68,0.3644859813084112
Chauncey Billups,2014.0,14,48,34,0.2916666666666667
Chaundee Brown Jr.,2022.0,6,18,12,0.3333333333333333
Cheick Diallo,2019.0,1,4,3,0.25
Cheick Diallo,2020.0,1,3,2,0.3333333333333333
Cheikh Samb,2009.0,0,3,3,0.0
Chet Holmgren,2024.0,73,193,120,0.37823834196891193
Chimezie Metu,2019.0,0,2,2,0.0
Chimezie Metu,2020.0,0,2,2,0.0
Chimezie Metu,2021.0,13,37,24,0.35135135135135137
Chimezie Metu,2022.0,57,186,129,0.3064516129032258
Chimezie Metu,2023.0,9,38,29,0.23684210526315788
Chimezie Metu,2024.0,15,51,36,0.29411764705882354
Chris Andersen,2004.0,0,1,1,0.0
Chris Andersen,2005.0,0,3,3,0.0
Chris Andersen,2009.0,2,11,9,0.18181818181818182
Chris Andersen,2010.0,0,3,3,0.0
Chris Andersen,2011.0,0,1,1,0.0
Chris Andersen,2013.0,2,3,1,0.6666666666666666
Chris Andersen,2014.0,3,13,10,0.23076923076923078
Chris Andersen,2015.0,4,13,9,0.3076923076923077
Chris Andersen,2016.0,4,14,10,0.2857142857142857
Chris Andersen,2017.0,0,3,3,0.0
Chris Babb,2014.0,6,27,21,0.2222222222222222
Chris Bosh,2004.0,5,14,9,0.35714285714285715
Chris Bosh,2005.0,3,10,7,0.3
Chris Bosh,2006.0,0,13,13,0.0
Chris Bosh,2007.0,13,40,27,0.325
Chris Bosh,2008.0,11,32,21,0.34375
Chris Bosh,2009.0,12,49,37,0.24489795918367346
Chris Bosh,2010.0,8,22,14,0.36363636363636365
Chris Bosh,2011.0,6,29,23,0.20689655172413793
Chris Bosh,2012.0,17,48,31,0.3541666666666667
Chris Bosh,2013.0,36,111,75,0.32432432432432434
Chris Bosh,2014.0,104,292,188,0.3561643835616438
Chris Bosh,2015.0,63,168,105,0.375
Chris Bosh,2016.0,81,222,141,0.36486486486486486
Chris Boucher,2018.0,0,1,1,0.0
Chris Boucher,2019.0,13,40,27,0.325
Chris Boucher,2020.0,40,123,83,0.3252032520325203
Chris Boucher,2021.0,90,235,145,0.3829787234042553
Chris Boucher,2022.0,74,244,170,0.30327868852459017
Chris Boucher,2023.0,62,189,127,0.328042328042328
Chris Boucher,2024.0,27,85,58,0.3176470588235294
Chris Chiozza,2019.0,2,5,3,0.4
Chris Chiozza,2020.0,32,88,56,0.36363636363636365
Chris Chiozza,2021.0,14,45,31,0.3111111111111111
Chris Chiozza,2022.0,17,53,36,0.32075471698113206
Chris Clemons,2020.0,39,112,73,0.3482142857142857
Chris Copeland,2013.0,70,163,93,0.4294478527607362
Chris Copeland,2014.0,39,95,56,0.4105263157894737
Chris Copeland,2015.0,52,167,115,0.31137724550898205
Chris Copeland,2016.0,10,36,26,0.2777777777777778
Chris Crawford,2004.0,44,113,69,0.3893805309734513
Chris Douglas-Roberts,2009.0,3,12,9,0.25
Chris Douglas-Roberts,2010.0,14,54,40,0.25925925925925924
Chris Douglas-Roberts,2011.0,15,46,31,0.32608695652173914
Chris Douglas-Roberts,2013.0,0,4,4,0.0
Chris Douglas-Roberts,2014.0,55,140,85,0.39285714285714285
Chris Douglas-Roberts,2015.0,1,7,6,0.14285714285714285
Chris Duarte,2022.0,94,255,161,0.3686274509803922
Chris Duarte,2023.0,55,173,118,0.3179190751445087
Chris Duarte,2024.0,21,67,46,0.31343283582089554
Chris Duhon,2005.0,100,287,187,0.34843205574912894
Chris Duhon,2006.0,106,291,185,0.3642611683848797
Chris Duhon,2007.0,94,264,170,0.3560606060606061
Chris Duhon,2008.0,54,155,101,0.34838709677419355
Chris Duhon,2009.0,127,325,198,0.39076923076923076
Chris Duhon,2010.0,90,258,168,0.3488372093023256
Chris Duhon,2011.0,14,54,40,0.25925925925925924
Chris Duhon,2012.0,51,122,71,0.4180327868852459
Chris Duhon,2013.0,36,99,63,0.36363636363636365
Chris Hunter,2010.0,0,4,4,0.0
Chris Jefferies,2004.0,17,42,25,0.40476190476190477
Chris Johnson,2013.0,6,18,12,0.3333333333333333
Chris Johnson,2014.0,43,127,84,0.33858267716535434
Chris Johnson,2015.0,28,95,67,0.29473684210526313
Chris Johnson,2016.0,27,99,72,0.2727272727272727
Chris Kaman,2004.0,0,2,2,0.0
Chris Kaman,2005.0,0,1,1,0.0
Chris Kaman,2006.0,0,2,2,0.0
Chris Kaman,2007.0,0,1,1,0.0
Chris Kaman,2008.0,0,4,4,0.0
Chris Kaman,2010.0,0,6,6,0.0
Chris Kaman,2013.0,0,1,1,0.0
Chris Kaman,2014.0,0,3,3,0.0
Chris Kaman,2016.0,1,4,3,0.25
Chris McCullough,2016.0,13,34,21,0.38235294117647056
Chris McCullough,2017.0,1,7,6,0.14285714285714285
Chris McCullough,2018.0,1,8,7,0.125
Chris Mihm,2005.0,0,2,2,0.0
Chris Paul,2006.0,50,177,127,0.2824858757062147
Chris Paul,2007.0,50,143,93,0.34965034965034963
Chris Paul,2008.0,97,270,173,0.3592592592592593
Chris Paul,2009.0,69,192,123,0.359375
Chris Paul,2010.0,52,127,75,0.4094488188976378
Chris Paul,2011.0,80,202,122,0.39603960396039606
Chris Paul,2012.0,92,252,160,0.36507936507936506
Chris Paul,2013.0,82,251,169,0.32669322709163345
Chris Paul,2014.0,110,282,172,0.3900709219858156
Chris Paul,2015.0,166,414,248,0.40096618357487923
Chris Paul,2016.0,128,349,221,0.3667621776504298
Chris Paul,2017.0,138,340,202,0.40588235294117647
Chris Paul,2018.0,181,478,297,0.3786610878661088
Chris Paul,2019.0,144,418,274,0.3444976076555024
Chris Paul,2020.0,127,347,220,0.3659942363112392
Chris Paul,2021.0,131,323,192,0.4055727554179567
Chris Paul,2022.0,82,248,166,0.33064516129032256
Chris Paul,2023.0,107,289,182,0.370242214532872
Chris Paul,2024.0,43,119,76,0.36134453781512604
Chris Quinn,2007.0,20,57,37,0.3508771929824561
Chris Quinn,2008.0,64,159,95,0.4025157232704403
Chris Quinn,2009.0,56,138,82,0.4057971014492754
Chris Quinn,2010.0,10,32,22,0.3125
Chris Quinn,2011.0,11,37,26,0.2972972972972973
Chris Quinn,2013.0,0,5,5,0.0
Chris Silva,2020.0,0,3,3,0.0
Chris Silva,2021.0,1,1,0,1.0
Chris Singleton,2012.0,44,127,83,0.3464566929133858
Chris Singleton,2013.0,7,36,29,0.19444444444444445
Chris Singleton,2014.0,7,19,12,0.3684210526315789
Chris Webber,2004.0,2,9,7,0.2222222222222222
Chris Webber,2005.0,20,58,38,0.3448275862068966
Chris Webber,2006.0,21,77,56,0.2727272727272727
Chris Webber,2007.0,4,12,8,0.3333333333333333
Chris Whitney,2004.0,8,18,10,0.4444444444444444
Chris Wilcox,2004.0,0,1,1,0.0
Chris Wilcox,2006.0,0,2,2,0.0
Chris Wilcox,2007.0,0,6,6,0.0
Chris Wilcox,2008.0,0,3,3,0.0
Chris Wilcox,2009.0,0,4,4,0.0
Chris Wilcox,2011.0,0,1,1,0.0
Chris Wilcox,2013.0,0,1,1,0.0
Chris Wright,2014.0,0,1,1,0.0
Christian Braun,2023.0,36,106,70,0.33962264150943394
Christian Braun,2024.0,31,87,56,0.3563218390804598
Christian Eyenga,2011.0,25,91,66,0.27472527472527475
Christian Eyenga,2012.0,1,3,2,0.3333333333333333
Christian Koloko,2023.0,1,12,11,0.08333333333333333
Christian Laettner,2004.0,6,21,15,0.2857142857142857
Christian Laettner,2005.0,1,8,7,0.125
Christian Wood,2016.0,4,11,7,0.36363636363636365
Christian Wood,2017.0,0,5,5,0.0
Christian Wood,2019.0,9,26,17,0.34615384615384615
Christian Wood,2020.0,54,140,86,0.38571428571428573
Christian Wood,2021.0,77,206,129,0.3737864077669903
Christian Wood,2022.0,131,336,205,0.3898809523809524
Christian Wood,2023.0,105,279,174,0.3763440860215054
Christian Wood,2024.0,31,96,65,0.3229166666666667
Chuck Hayes,2006.0,0,1,1,0.0
Chuck Hayes,2007.0,0,1,1,0.0
Chuck Hayes,2008.0,0,5,5,0.0
Chuck Hayes,2009.0,0,6,6,0.0
Chuck Hayes,2011.0,0,2,2,0.0
Chuck Hayes,2012.0,0,2,2,0.0
Chuck Hayes,2013.0,0,1,1,0.0
Chuck Hayes,2014.0,0,1,1,0.0
Chucky Atkins,2004.0,84,251,167,0.3346613545816733
Chucky Atkins,2005.0,176,455,279,0.3868131868131868
Chucky Atkins,2006.0,101,285,184,0.3543859649122807
Chucky Atkins,2007.0,116,306,190,0.3790849673202614
Chucky Atkins,2008.0,25,80,55,0.3125
Chucky Atkins,2009.0,15,57,42,0.2631578947368421
Chucky Atkins,2010.0,22,73,51,0.3013698630136986
Chuma Okeke,2021.0,49,141,92,0.3475177304964539
Chuma Okeke,2022.0,118,371,253,0.31805929919137466
Chuma Okeke,2023.0,26,86,60,0.3023255813953488
Chuma Okeke,2024.0,22,70,48,0.3142857142857143
Clarence Weatherspoon,2004.0,0,1,1,0.0
Cleanthony Early,2015.0,22,84,62,0.2619047619047619
Cleanthony Early,2016.0,4,15,11,0.26666666666666666
Clifford Robinson,2004.0,112,314,202,0.35668789808917195
Clifford Robinson,2005.0,71,207,136,0.34299516908212563
Clifford Robinson,2006.0,66,194,128,0.3402061855670103
Clifford Robinson,2007.0,26,68,42,0.38235294117647056
Clint Capela,2016.0,0,1,1,0.0
Clint Capela,2017.0,0,1,1,0.0
Clint Capela,2018.0,0,1,1,0.0
Clint Capela,2022.0,0,1,1,0.0
Clint Capela,2023.0,0,1,1,0.0
Coby Karl,2008.0,4,13,9,0.3076923076923077
Coby Karl,2010.0,2,11,9,0.18181818181818182
Coby White,2020.0,133,376,243,0.3537234042553192
Coby White,2021.0,163,454,291,0.3590308370044053
Coby White,2022.0,144,382,238,0.3769633507853403
Coby White,2023.0,128,344,216,0.37209302325581395
Coby White,2024.0,131,334,203,0.39221556886227543
Cody Martin,2020.0,18,77,59,0.23376623376623376
Cody Martin,2021.0,16,58,42,0.27586206896551724
Cody Martin,2022.0,61,160,99,0.38125
Cody Martin,2023.0,3,14,11,0.21428571428571427
Cody Martin,2024.0,12,41,29,0.2926829268292683
Cody Zeller,2014.0,0,1,1,0.0
Cody Zeller,2015.0,1,1,0,1.0
Cody Zeller,2016.0,1,10,9,0.1
Cody Zeller,2017.0,0,1,1,0.0
Cody Zeller,2018.0,2,3,1,0.6666666666666666
Cody Zeller,2019.0,6,22,16,0.2727272727272727
Cody Zeller,2020.0,18,75,57,0.24
Cody Zeller,2021.0,4,28,24,0.14285714285714285
Cody Zeller,2022.0,0,4,4,0.0
Cody Zeller,2023.0,0,2,2,0.0
Cody Zeller,2024.0,1,3,2,0.3333333333333333
Colby Jones,2024.0,0,9,9,0.0
Cole Anthony,2021.0,58,172,114,0.3372093023255814
Cole Anthony,2022.0,132,391,259,0.3375959079283887
Cole Anthony,2023.0,75,206,131,0.3640776699029126
Cole Anthony,2024.0,52,160,108,0.325
Cole Swider,2023.0,3,8,5,0.375
Cole Swider,2024.0,5,15,10,0.3333333333333333
Colin Castleton,2024.0,3,5,2,0.6
Collin Gillespie,2024.0,4,13,9,0.3076923076923077
Collin Sexton,2019.0,119,296,177,0.40202702702702703
Collin Sexton,2020.0,97,255,158,0.3803921568627451
Collin Sexton,2021.0,98,264,166,0.3712121212121212
Collin Sexton,2022.0,11,45,34,0.24444444444444444
Collin Sexton,2023.0,48,122,74,0.39344262295081966
Collin Sexton,2024.0,71,186,115,0.3817204301075269
Corey Brewer,2008.0,7,36,29,0.19444444444444445
Corey Brewer,2009.0,5,12,7,0.4166666666666667
Corey Brewer,2010.0,82,237,155,0.3459915611814346
Corey Brewer,2011.0,31,115,84,0.26956521739130435
Corey Brewer,2012.0,39,147,108,0.2653061224489796
Corey Brewer,2013.0,100,343,243,0.2915451895043732
Corey Brewer,2014.0,59,211,152,0.2796208530805687
Corey Brewer,2015.0,75,277,202,0.27075812274368233
Corey Brewer,2016.0,62,234,172,0.26495726495726496
Corey Brewer,2017.0,27,118,91,0.2288135593220339
Corey Brewer,2018.0,36,121,85,0.2975206611570248
Corey Brewer,2019.0,14,44,30,0.3181818181818182
Corey Brewer,2020.0,0,1,1,0.0
Corey Kispert,2022.0,112,320,208,0.35
Corey Kispert,2023.0,163,385,222,0.42337662337662335
Corey Kispert,2024.0,82,226,144,0.36283185840707965
Corey Maggette,2004.0,76,231,155,0.329004329004329
Corey Maggette,2005.0,51,168,117,0.30357142857142855
Corey Maggette,2006.0,32,95,63,0.3368421052631579
Corey Maggette,2007.0,13,65,52,0.2
Corey Maggette,2008.0,78,203,125,0.3842364532019704
Corey Maggette,2009.0,24,95,71,0.25263157894736843
Corey Maggette,2010.0,13,50,37,0.26
Corey Maggette,2011.0,28,78,50,0.358974358974359
Corey Maggette,2012.0,24,66,42,0.36363636363636365
Corey Maggette,2013.0,5,21,16,0.23809523809523808
Corie Blount,2004.0,0,3,3,0.0
Corliss Williamson,2004.0,0,1,1,0.0
Corliss Williamson,2005.0,0,3,3,0.0
Corliss Williamson,2006.0,2,2,0,1.0
Corliss Williamson,2007.0,0,2,2,0.0
Cory Alexander,2005.0,8,19,11,0.42105263157894735
Cory Higgins,2012.0,4,20,16,0.2
Cory Higgins,2013.0,1,5,4,0.2
Cory Jefferson,2015.0,2,15,13,0.13333333333333333
Cory Jefferson,2016.0,0,1,1,0.0
Cory Joseph,2012.0,3,15,12,0.2
Cory Joseph,2013.0,8,32,24,0.25
Cory Joseph,2014.0,12,41,29,0.2926829268292683
Cory Joseph,2015.0,16,44,28,0.36363636363636365
Cory Joseph,2016.0,38,134,96,0.2835820895522388
Cory Joseph,2017.0,57,156,99,0.36538461538461536
Cory Joseph,2018.0,70,201,131,0.3482587064676617
Cory Joseph,2019.0,59,180,121,0.3277777777777778
Cory Joseph,2020.0,56,159,103,0.3522012578616352
Cory Joseph,2021.0,45,132,87,0.3409090909090909
Cory Joseph,2022.0,65,157,92,0.4140127388535032
Cory Joseph,2023.0,70,180,110,0.3888888888888889
Cory Joseph,2024.0,11,37,26,0.2972972972972973
Coty Clarke,2016.0,2,2,0,1.0
Courtney Fortson,2012.0,3,13,10,0.23076923076923078
Courtney Lee,2009.0,94,247,153,0.3805668016194332
Courtney Lee,2010.0,76,225,149,0.3377777777777778
Courtney Lee,2011.0,71,174,103,0.40804597701149425
Courtney Lee,2012.0,87,217,130,0.4009216589861751
Courtney Lee,2013.0,58,158,100,0.3670886075949367
Courtney Lee,2014.0,78,213,135,0.36619718309859156
Courtney Lee,2015.0,104,254,150,0.4094488188976378
Courtney Lee,2016.0,86,226,140,0.3805309734513274
Courtney Lee,2017.0,108,268,160,0.40298507462686567
Courtney Lee,2018.0,113,278,165,0.4064748201438849
Courtney Lee,2019.0,16,55,39,0.2909090909090909
Courtney Lee,2020.0,21,47,26,0.44680851063829785
Craig Brackins,2011.0,0,5,5,0.0
Craig Brackins,2012.0,3,9,6,0.3333333333333333
Craig Porter,2024.0,7,21,14,0.3333333333333333
Craig Smith,2007.0,0,6,6,0.0
Craig Smith,2008.0,0,9,9,0.0
Craig Smith,2009.0,0,1,1,0.0
Craig Smith,2010.0,1,5,4,0.2
Craig Smith,2011.0,0,5,5,0.0
Craig Smith,2012.0,0,1,1,0.0
Craig Sword,2022.0,0,1,1,0.0
Cristiano Felicio,2016.0,0,4,4,0.0
Cristiano Felicio,2018.0,0,2,2,0.0
Cristiano Felicio,2019.0,0,4,4,0.0
Cristiano Felicio,2020.0,0,2,2,0.0
Cristiano Felicio,2021.0,0,2,2,0.0
Curtis Borchardt,2004.0,0,1,1,0.0
Cuttino Mobley,2004.0,170,441,271,0.3854875283446712
Cuttino Mobley,2005.0,157,367,210,0.42779291553133514
Cuttino Mobley,2006.0,94,275,181,0.3418181818181818
Cuttino Mobley,2007.0,101,246,145,0.4105691056910569
Cuttino Mobley,2008.0,67,192,125,0.3489583333333333
Cuttino Mobley,2009.0,12,35,23,0.34285714285714286
D'Angelo Russell,2016.0,130,370,240,0.35135135135135137
D'Angelo Russell,2017.0,135,385,250,0.35064935064935066
D'Angelo Russell,2018.0,90,277,187,0.3249097472924188
D'Angelo Russell,2019.0,246,672,426,0.36607142857142855
D'Angelo Russell,2020.0,158,431,273,0.3665893271461717
D'Angelo Russell,2021.0,120,310,190,0.3870967741935484
D'Angelo Russell,2022.0,188,549,361,0.3424408014571949
D'Angelo Russell,2023.0,221,576,355,0.3836805555555556
D'Angelo Russell,2024.0,111,262,151,0.42366412213740456
D'Moi Hodge,2024.0,3,10,7,0.3
D.J. Augustin,2009.0,108,246,138,0.43902439024390244
D.J. Augustin,2010.0,72,184,112,0.391304347826087
D.J. Augustin,2011.0,111,333,222,0.3333333333333333
D.J. Augustin,2012.0,61,179,118,0.3407821229050279
D.J. Augustin,2013.0,86,238,152,0.36134453781512604
D.J. Augustin,2014.0,140,358,218,0.39106145251396646
D.J. Augustin,2015.0,83,246,163,0.33739837398373984
D.J. Augustin,2016.0,68,168,100,0.40476190476190477
D.J. Augustin,2017.0,95,274,179,0.3467153284671533
D.J. Augustin,2018.0,114,272,158,0.41911764705882354
D.J. Augustin,2019.0,141,332,191,0.4246987951807229
D.J. Augustin,2020.0,78,219,141,0.3561643835616438
D.J. Augustin,2021.0,83,216,133,0.38425925925925924
D.J. Augustin,2022.0,68,164,96,0.4146341463414634
D.J. Kennedy,2012.0,2,4,2,0.5
D.J. Strawberry,2008.0,6,26,20,0.23076923076923078
D.J. White,2011.0,0,2,2,0.0
D.J. White,2012.0,1,1,0,1.0
D.J. Wilson,2018.0,2,5,3,0.4
D.J. Wilson,2019.0,47,132,85,0.3560606060606061
D.J. Wilson,2020.0,18,73,55,0.2465753424657534
D.J. Wilson,2021.0,30,87,57,0.3448275862068966
D.J. Wilson,2022.0,0,2,2,0.0
DaJuan Summers,2010.0,15,42,27,0.35714285714285715
DaJuan Summers,2011.0,9,21,12,0.42857142857142855
DaJuan Summers,2012.0,5,16,11,0.3125
DaQuan Jeffries,2020.0,5,18,13,0.2777777777777778
DaQuan Jeffries,2021.0,20,67,47,0.29850746268656714
DaQuan Jeffries,2022.0,0,1,1,0.0
DaQuan Jeffries,2024.0,1,5,4,0.2
Daequan Cook,2008.0,79,238,159,0.3319327731092437
Daequan Cook,2009.0,162,425,263,0.3811764705882353
Daequan Cook,2010.0,40,126,86,0.31746031746031744
Daequan Cook,2011.0,81,200,119,0.405
Daequan Cook,2012.0,87,252,165,0.34523809523809523
Daequan Cook,2013.0,27,99,72,0.2727272727272727
Dahntay Jones,2004.0,1,4,3,0.25
Dahntay Jones,2005.0,26,65,39,0.4
Dahntay Jones,2006.0,3,21,18,0.14285714285714285
Dahntay Jones,2007.0,5,12,7,0.4166666666666667
Dahntay Jones,2008.0,1,6,5,0.16666666666666666
Dahntay Jones,2009.0,14,29,15,0.4827586206896552
Dahntay Jones,2010.0,4,32,28,0.125
Dahntay Jones,2011.0,14,42,28,0.3333333333333333
Dahntay Jones,2012.0,35,86,51,0.4069767441860465
Dahntay Jones,2013.0,11,49,38,0.22448979591836735
Dahntay Jones,2015.0,0,4,4,0.0
Dahntay Jones,2016.0,2,5,3,0.4
Dahntay Jones,2017.0,1,4,3,0.25
Dairis Bertans,2019.0,10,34,24,0.29411764705882354
Daishen Nix,2022.0,7,26,19,0.2692307692307692
Daishen Nix,2023.0,40,139,99,0.28776978417266186
Daishen Nix,2024.0,2,5,3,0.4
Dajuan Wagner,2004.0,31,86,55,0.36046511627906974
Dajuan Wagner,2005.0,5,26,21,0.19230769230769232
Dajuan Wagner,2007.0,1,1,0,1.0
Dakota Mathias,2021.0,8,26,18,0.3076923076923077
Dakota Mathias,2022.0,2,6,4,0.3333333333333333
Dalano Banton,2022.0,13,51,38,0.2549019607843137
Dalano Banton,2023.0,15,51,36,0.29411764705882354
Dalano Banton,2024.0,2,14,12,0.14285714285714285
Dale Davis,2006.0,0,1,1,0.0
Dalen Terry,2023.0,7,27,20,0.25925925925925924
Dalen Terry,2024.0,8,37,29,0.21621621621621623
Damian Jones,2020.0,2,9,7,0.2222222222222222
Damian Jones,2021.0,1,5,4,0.2
Damian Jones,2022.0,10,29,19,0.3448275862068966
Damian Jones,2023.0,10,17,7,0.5882352941176471
Damian Jones,2024.0,2,7,5,0.2857142857142857
Damian Lillard,2013.0,184,498,314,0.36947791164658633
Damian Lillard,2014.0,245,624,379,0.3926282051282051
Damian Lillard,2015.0,201,603,402,0.3333333333333333
Damian Lillard,2016.0,271,717,446,0.37796373779637377
Damian Lillard,2017.0,223,609,386,0.36617405582922824
Damian Lillard,2018.0,236,659,423,0.3581183611532625
Damian Lillard,2019.0,296,801,505,0.36953807740324596
Damian Lillard,2020.0,288,721,433,0.39944521497919555
Damian Lillard,2021.0,310,782,472,0.39641943734015345
Damian Lillard,2022.0,92,284,192,0.323943661971831
Damian Lillard,2023.0,244,658,414,0.3708206686930091
Damian Lillard,2024.0,128,371,243,0.3450134770889488
Damien Inglis,2016.0,3,13,10,0.23076923076923078
Damien Wilkins,2005.0,19,70,51,0.2714285714285714
Damien Wilkins,2006.0,14,56,42,0.25
Damien Wilkins,2007.0,50,122,72,0.4098360655737705
Damien Wilkins,2008.0,50,155,105,0.3225806451612903
Damien Wilkins,2009.0,27,72,45,0.375
Damien Wilkins,2010.0,18,61,43,0.29508196721311475
Damien Wilkins,2011.0,2,12,10,0.16666666666666666
Damien Wilkins,2012.0,7,23,16,0.30434782608695654
Damien Wilkins,2013.0,17,51,34,0.3333333333333333
Damien Wilkins,2018.0,4,18,14,0.2222222222222222
Damion James,2011.0,0,3,3,0.0
Damion James,2012.0,0,1,1,0.0
Damion James,2014.0,0,2,2,0.0
Damion Lee,2018.0,15,60,45,0.25
Damion Lee,2019.0,27,68,41,0.39705882352941174
Damion Lee,2020.0,85,239,154,0.35564853556485354
Damion Lee,2021.0,77,194,117,0.39690721649484534
Damion Lee,2022.0,67,203,136,0.33004926108374383
Damion Lee,2023.0,113,262,149,0.4312977099236641
Damir Markota,2007.0,6,16,10,0.375
Damjan Rudez,2015.0,69,170,101,0.40588235294117647
Damjan Rudez,2016.0,17,50,33,0.34
Damjan Rudez,2017.0,20,64,44,0.3125
Damon Jones,2004.0,108,294,186,0.3673469387755102
Damon Jones,2005.0,264,612,348,0.43137254901960786
Damon Jones,2006.0,145,389,244,0.37275064267352187
Damon Jones,2007.0,96,253,157,0.3794466403162055
Damon Jones,2008.0,117,283,166,0.4134275618374558
Damon Jones,2009.0,11,28,17,0.39285714285714285
Damon Stoudamire,2004.0,156,427,271,0.36533957845433257
Damon Stoudamire,2005.0,181,490,309,0.3693877551020408
Damon Stoudamire,2006.0,36,104,68,0.34615384615384615
Damon Stoudamire,2007.0,59,175,116,0.33714285714285713
Damon Stoudamire,2008.0,51,153,102,0.3333333333333333
Damone Brown,2005.0,4,11,7,0.36363636363636365
Damyean Dotson,2018.0,22,68,46,0.3235294117647059
Damyean Dotson,2019.0,126,342,216,0.3684210526315789
Damyean Dotson,2020.0,59,163,104,0.3619631901840491
Damyean Dotson,2021.0,46,159,113,0.2893081761006289
Damyean Dotson,2022.0,0,1,1,0.0
Dan Dickau,2004.0,10,30,20,0.3333333333333333
Dan Dickau,2005.0,85,245,160,0.3469387755102041
Dan Dickau,2006.0,10,20,10,0.5
Dan Dickau,2007.0,16,61,45,0.26229508196721313
Dan Dickau,2008.0,36,108,72,0.3333333333333333
Dan Gadzuric,2004.0,0,1,1,0.0
Dan Gadzuric,2006.0,0,1,1,0.0
Dan Gadzuric,2007.0,0,1,1,0.0
Dan Gadzuric,2008.0,0,1,1,0.0
Dan Gadzuric,2009.0,0,2,2,0.0
Dan Gadzuric,2011.0,0,1,1,0.0
Dan Langhi,2004.0,1,2,1,0.5
Daniel Ewing,2006.0,22,78,56,0.28205128205128205
Daniel Ewing,2007.0,14,44,30,0.3181818181818182
Daniel Gafford,2022.0,0,1,1,0.0
Daniel Gibson,2007.0,79,190,111,0.41578947368421054
Daniel Gibson,2008.0,137,310,173,0.44193548387096776
Daniel Gibson,2009.0,118,311,193,0.37942122186495175
Daniel Gibson,2010.0,72,153,81,0.47058823529411764
Daniel Gibson,2011.0,118,293,175,0.40273037542662116
Daniel Gibson,2012.0,55,139,84,0.39568345323741005
Daniel Gibson,2013.0,56,163,107,0.34355828220858897
Daniel Hamilton,2018.0,2,5,3,0.4
Daniel Hamilton,2019.0,8,23,15,0.34782608695652173
Daniel Orton,2012.0,0,1,1,0.0
Daniel Oturu,2021.0,1,6,5,0.16666666666666666
Daniel Oturu,2022.0,0,1,1,0.0
Daniel Theis,2018.0,18,58,40,0.3103448275862069
Daniel Theis,2019.0,26,69,43,0.37681159420289856
Daniel Theis,2020.0,36,122,86,0.29508196721311475
Daniel Theis,2021.0,47,149,102,0.31543624161073824
Daniel Theis,2022.0,36,121,85,0.2975206611570248
Daniel Theis,2023.0,2,11,9,0.18181818181818182
Daniel Theis,2024.0,15,35,20,0.42857142857142855
Danilo Gallinari,2009.0,32,72,40,0.4444444444444444
Danilo Gallinari,2010.0,186,488,302,0.38114754098360654
Danilo Gallinari,2011.0,110,308,198,0.35714285714285715
Danilo Gallinari,2012.0,64,206,142,0.3106796116504854
Danilo Gallinari,2013.0,135,362,227,0.3729281767955801
Danilo Gallinari,2015.0,107,301,194,0.3554817275747508
Danilo Gallinari,2016.0,87,239,152,0.36401673640167365
Danilo Gallinari,2017.0,126,325,199,0.38769230769230767
Danilo Gallinari,2018.0,36,111,75,0.32432432432432434
Danilo Gallinari,2019.0,174,416,242,0.4182692307692308
Danilo Gallinari,2020.0,190,476,286,0.39915966386554624
Danilo Gallinari,2021.0,137,338,201,0.40532544378698226
Danilo Gallinari,2022.0,120,320,200,0.375
Danilo Gallinari,2024.0,22,66,44,0.3333333333333333
Danny Fortson,2007.0,0,1,1,0.0
Danny Granger,2006.0,39,109,70,0.3577981651376147
Danny Granger,2007.0,110,288,178,0.3819444444444444
Danny Granger,2008.0,171,423,252,0.40425531914893614
Danny Granger,2009.0,182,450,268,0.40444444444444444
Danny Granger,2010.0,158,438,280,0.3607305936073059
Danny Granger,2011.0,165,430,265,0.38372093023255816
Danny Granger,2012.0,149,396,247,0.37626262626262624
Danny Granger,2013.0,2,10,8,0.2
Danny Granger,2014.0,48,150,102,0.32
Danny Granger,2015.0,30,84,54,0.35714285714285715
Danny Green,2010.0,6,22,16,0.2727272727272727
Danny Green,2011.0,8,23,15,0.34782608695652173
Danny Green,2012.0,122,292,170,0.4178082191780822
Danny Green,2013.0,232,527,295,0.44022770398481975
Danny Green,2014.0,180,419,239,0.4295942720763723
Danny Green,2015.0,203,497,294,0.4084507042253521
Danny Green,2016.0,140,397,257,0.3526448362720403
Danny Green,2017.0,144,386,242,0.37305699481865284
Danny Green,2018.0,121,340,219,0.3558823529411765
Danny Green,2019.0,237,554,317,0.427797833935018
Danny Green,2020.0,159,442,283,0.3597285067873303
Danny Green,2021.0,189,469,280,0.40298507462686567
Danny Green,2022.0,134,347,213,0.3861671469740634
Danny Green,2023.0,17,41,24,0.4146341463414634
Danny Green,2024.0,0,1,1,0.0
Dante Cunningham,2010.0,0,3,3,0.0
Dante Cunningham,2011.0,1,13,12,0.07692307692307693
Dante Cunningham,2012.0,0,2,2,0.0
Dante Cunningham,2013.0,0,6,6,0.0
Dante Cunningham,2014.0,0,5,5,0.0
Dante Cunningham,2015.0,1,10,9,0.1
Dante Cunningham,2016.0,55,174,119,0.3160919540229885
Dante Cunningham,2017.0,71,182,111,0.3901098901098901
Dante Cunningham,2018.0,58,168,110,0.34523809523809523
Dante Cunningham,2019.0,32,67,35,0.47761194029850745
Dante Exum,2015.0,83,264,181,0.3143939393939394
Dante Exum,2017.0,48,161,113,0.2981366459627329
Dante Exum,2018.0,7,25,18,0.28
Dante Exum,2019.0,18,62,44,0.2903225806451613
Dante Exum,2020.0,15,43,28,0.3488372093023256
Dante Exum,2021.0,2,11,9,0.18181818181818182
Dante Exum,2024.0,31,65,34,0.47692307692307695
Danuel House,2018.0,15,58,43,0.25862068965517243
Danuel House,2019.0,82,209,127,0.3923444976076555
Danuel House,2020.0,148,408,260,0.3627450980392157
Danuel House,2021.0,54,156,102,0.34615384615384615
Danuel House,2022.0,46,127,81,0.36220472440944884
Danuel House,2023.0,38,120,82,0.31666666666666665
Danuel House,2024.0,14,42,28,0.3333333333333333
Darington Hobson,2012.0,0,6,6,0.0
Dario Saric,2017.0,106,341,235,0.31085043988269795
Dario Saric,2018.0,177,451,274,0.3924611973392461
Dario Saric,2019.0,118,324,206,0.36419753086419754
Dario Saric,2020.0,84,235,151,0.3574468085106383
Dario Saric,2021.0,55,153,98,0.35947712418300654
Dario Saric,2023.0,45,115,70,0.391304347826087
Dario Saric,2024.0,68,164,96,0.4146341463414634
Dariq Whitehead,2024.0,0,3,3,0.0
Darius Bazley,2020.0,60,163,103,0.36809815950920244
Darius Bazley,2021.0,83,286,203,0.2902097902097902
Darius Bazley,2022.0,80,269,189,0.29739776951672864
Darius Bazley,2023.0,20,53,33,0.37735849056603776
Darius Days,2023.0,3,10,7,0.3
Darius Garland,2020.0,105,296,191,0.3547297297297297
Darius Garland,2021.0,105,266,161,0.39473684210526316
Darius Garland,2022.0,175,461,286,0.3796095444685466
Darius Garland,2023.0,181,443,262,0.40857787810383744
Darius Garland,2024.0,36,104,68,0.34615384615384615
Darius Johnson-Odom,2013.0,0,1,1,0.0
Darius Johnson-Odom,2014.0,0,3,3,0.0
Darius Miles,2004.0,7,40,33,0.175
Darius Miles,2005.0,8,23,15,0.34782608695652173
Darius Miles,2006.0,2,10,8,0.2
Darius Miles,2009.0,1,6,5,0.16666666666666666
Darius Miller,2013.0,22,56,34,0.39285714285714285
Darius Miller,2014.0,25,77,52,0.3246753246753247
Darius Miller,2015.0,0,1,1,0.0
Darius Miller,2018.0,156,382,226,0.4083769633507853
Darius Miller,2019.0,133,364,231,0.36538461538461536
Darius Miller,2021.0,17,42,25,0.40476190476190477
Darius Morris,2012.0,5,10,5,0.5
Darius Morris,2013.0,27,75,48,0.36
Darius Morris,2014.0,12,38,26,0.3157894736842105
Darius Morris,2015.0,7,33,26,0.21212121212121213
Darius Songaila,2005.0,0,3,3,0.0
Darius Songaila,2006.0,2,5,3,0.4
Darius Songaila,2007.0,0,4,4,0.0
Darius Songaila,2008.0,0,2,2,0.0
Darius Songaila,2009.0,0,1,1,0.0
Darius Songaila,2010.0,1,6,5,0.16666666666666666
Darius Washington,2008.0,4,12,8,0.3333333333333333
Darko Milicic,2004.0,0,1,1,0.0
Darko Milicic,2006.0,0,2,2,0.0
Darko Milicic,2007.0,0,1,1,0.0
Darko Milicic,2008.0,0,1,1,0.0
Darko Milicic,2010.0,0,1,1,0.0
Darnell Jackson,2009.0,0,2,2,0.0
Darnell Jackson,2010.0,1,4,3,0.25
Darnell Jackson,2011.0,3,11,8,0.2727272727272727
Darrell Armstrong,2004.0,140,454,314,0.30837004405286345
Darrell Armstrong,2005.0,30,119,89,0.25210084033613445
Darrell Armstrong,2006.0,11,55,44,0.2
Darrell Armstrong,2007.0,72,214,142,0.3364485981308411
Darrell Armstrong,2008.0,23,69,46,0.3333333333333333
Darrell Arthur,2009.0,0,2,2,0.0
Darrell Arthur,2010.0,0,1,1,0.0
Darrell Arthur,2011.0,1,7,6,0.14285714285714285
Darrell Arthur,2013.0,5,20,15,0.25
Darrell Arthur,2014.0,24,64,40,0.375
Darrell Arthur,2015.0,26,110,84,0.23636363636363636
Darrell Arthur,2016.0,45,117,72,0.38461538461538464
Darrell Arthur,2017.0,53,117,64,0.452991452991453
Darrell Arthur,2018.0,8,23,15,0.34782608695652173
Darren Collison,2010.0,46,115,69,0.4
Darren Collison,2011.0,45,130,85,0.34615384615384615
Darren Collison,2012.0,38,105,67,0.3619047619047619
Darren Collison,2013.0,48,136,88,0.35294117647058826
Darren Collison,2014.0,72,201,129,0.3582089552238806
Darren Collison,2015.0,60,161,101,0.37267080745341613
Darren Collison,2016.0,87,217,130,0.4009216589861751
Darren Collison,2017.0,73,174,101,0.41954022988505746
Darren Collison,2018.0,104,228,124,0.45614035087719296
Darren Collison,2019.0,83,205,122,0.40487804878048783
Darren Collison,2022.0,0,3,3,0.0
Darrick Martin,2004.0,12,46,34,0.2608695652173913
Darrick Martin,2005.0,5,18,13,0.2777777777777778
Darrick Martin,2006.0,16,40,24,0.4
Darrick Martin,2007.0,13,39,26,0.3333333333333333
Darrick Martin,2008.0,2,16,14,0.125
Darrun Hilliard,2016.0,19,50,31,0.38
Darrun Hilliard,2017.0,12,46,34,0.2608695652173913
Darrun Hilliard,2018.0,0,6,6,0.0
Darvin Ham,2004.0,1,3,2,0.3333333333333333
Daryl Macon,2019.0,5,11,6,0.45454545454545453
Daryl Macon,2020.0,1,2,1,0.5
David Andersen,2010.0,27,78,51,0.34615384615384615
David Andersen,2011.0,8,23,15,0.34782608695652173
David Duke,2022.0,9,37,28,0.24324324324324326
David Duke,2023.0,1,13,12,0.07692307692307693
David Johnson,2022.0,0,1,1,0.0
David Lee,2008.0,0,2,2,0.0
David Lee,2009.0,0,3,3,0.0
David Lee,2010.0,0,8,8,0.0
David Lee,2011.0,1,3,2,0.3333333333333333
David Lee,2012.0,0,5,5,0.0
David Lee,2013.0,0,4,4,0.0
David Lee,2014.0,0,1,1,0.0
David Lee,2015.0,0,2,2,0.0
David Lee,2016.0,0,1,1,0.0
David Lee,2017.0,0,1,1,0.0
David Noel,2007.0,17,53,36,0.32075471698113206
David Nwaba,2017.0,1,5,4,0.2
David Nwaba,2018.0,18,52,34,0.34615384615384615
David Nwaba,2019.0,24,75,51,0.32
David Nwaba,2020.0,12,28,16,0.42857142857142855
David Nwaba,2021.0,17,63,46,0.2698412698412698
David Nwaba,2022.0,15,49,34,0.30612244897959184
David Roddy,2023.0,71,232,161,0.30603448275862066
David Roddy,2024.0,43,137,94,0.31386861313868614
David Stockton,2015.0,1,2,1,0.5
David Stockton,2018.0,2,4,2,0.5
David Wear,2015.0,0,1,1,0.0
David Wesley,2004.0,103,315,212,0.326984126984127
David Wesley,2005.0,128,336,208,0.38095238095238093
David Wesley,2006.0,99,271,172,0.36531365313653136
David Wesley,2007.0,9,38,29,0.23684210526315788
David West,2004.0,0,2,2,0.0
David West,2005.0,2,5,3,0.4
David West,2006.0,3,11,8,0.2727272727272727
David West,2007.0,8,25,17,0.32
David West,2008.0,7,27,20,0.25925925925925924
David West,2009.0,6,25,19,0.24
David West,2010.0,7,27,20,0.25925925925925924
David West,2011.0,2,9,7,0.2222222222222222
David West,2012.0,2,9,7,0.2222222222222222
David West,2013.0,4,22,18,0.18181818181818182
David West,2014.0,6,25,19,0.24
David West,2015.0,4,20,16,0.2
David West,2016.0,6,13,7,0.46153846153846156
David West,2017.0,4,10,6,0.4
David West,2018.0,4,10,6,0.4
Davion Mitchell,2022.0,101,320,219,0.315625
Davion Mitchell,2023.0,70,224,154,0.3125
Davion Mitchell,2024.0,17,64,47,0.265625
Davis Bertans,2017.0,77,193,116,0.39896373056994816
Davis Bertans,2018.0,97,268,171,0.3619402985074627
Davis Bertans,2019.0,148,349,201,0.42406876790830944
Davis Bertans,2020.0,200,472,272,0.423728813559322
Davis Bertans,2021.0,179,464,285,0.3857758620689655
Davis Bertans,2022.0,96,281,185,0.3416370106761566
Davis Bertans,2023.0,55,141,86,0.3900709219858156
Davis Bertans,2024.0,10,24,14,0.4166666666666667
Davon Reed,2018.0,11,38,27,0.2894736842105263
Davon Reed,2019.0,2,4,2,0.5
Davon Reed,2022.0,37,86,49,0.43023255813953487
Davon Reed,2023.0,17,46,29,0.3695652173913043
Day'Ron Sharpe,2022.0,2,7,5,0.2857142857142857
Day'Ron Sharpe,2023.0,6,11,5,0.5454545454545454
Day'Ron Sharpe,2024.0,1,7,6,0.14285714285714285
De'Aaron Fox,2018.0,47,153,106,0.30718954248366015
De'Aaron Fox,2019.0,86,232,146,0.3706896551724138
De'Aaron Fox,2020.0,54,185,131,0.2918918918918919
De'Aaron Fox,2021.0,103,320,217,0.321875
De'Aaron Fox,2022.0,74,249,175,0.2971887550200803
De'Aaron Fox,2023.0,140,429,289,0.32634032634032634
De'Aaron Fox,2024.0,118,304,186,0.3881578947368421
De'Andre Hunter,2020.0,108,304,196,0.35526315789473684
De'Andre Hunter,2021.0,37,112,75,0.33035714285714285
De'Andre Hunter,2022.0,88,229,141,0.38427947598253276
De'Andre Hunter,2023.0,114,324,210,0.35185185185185186
De'Andre Hunter,2024.0,46,114,68,0.40350877192982454
De'Anthony Melton,2019.0,29,95,66,0.30526315789473685
De'Anthony Melton,2020.0,41,141,100,0.2907801418439716
De'Anthony Melton,2021.0,94,235,141,0.4
De'Anthony Melton,2022.0,150,416,266,0.3605769230769231
De'Anthony Melton,2023.0,176,452,276,0.3893805309734513
De'Anthony Melton,2024.0,70,193,123,0.3626943005181347
DeAndre Jordan,2010.0,0,2,2,0.0
DeAndre Jordan,2011.0,0,1,1,0.0
DeAndre Jordan,2012.0,0,1,1,0.0
DeAndre Jordan,2015.0,1,4,3,0.25
DeAndre Jordan,2016.0,0,1,1,0.0
DeAndre Jordan,2017.0,0,3,3,0.0
DeAndre Jordan,2021.0,0,1,1,0.0
DeAndre Jordan,2023.0,1,1,0,1.0
DeAndre Liggins,2012.0,0,4,4,0.0
DeAndre Liggins,2013.0,8,24,16,0.3333333333333333
DeAndre Liggins,2017.0,17,46,29,0.3695652173913043
DeAndre Liggins,2018.0,19,53,34,0.3584905660377358
DeAndre' Bembry,2017.0,1,18,17,0.05555555555555555
DeAndre' Bembry,2018.0,11,30,19,0.36666666666666664
DeAndre' Bembry,2019.0,50,173,123,0.28901734104046245
DeAndre' Bembry,2020.0,15,65,50,0.23076923076923078
DeAndre' Bembry,2021.0,14,53,39,0.2641509433962264
DeAndre' Bembry,2022.0,15,36,21,0.4166666666666667
DeJuan Blair,2010.0,0,2,2,0.0
DeJuan Blair,2011.0,0,2,2,0.0
DeJuan Blair,2012.0,0,1,1,0.0
DeJuan Blair,2013.0,0,1,1,0.0
DeJuan Blair,2014.0,0,2,2,0.0
DeJuan Blair,2016.0,0,1,1,0.0
DeMar DeRozan,2010.0,4,16,12,0.25
DeMar DeRozan,2011.0,5,52,47,0.09615384615384616
DeMar DeRozan,2012.0,24,92,68,0.2608695652173913
DeMar DeRozan,2013.0,34,120,86,0.2833333333333333
DeMar DeRozan,2014.0,70,228,158,0.30701754385964913
DeMar DeRozan,2015.0,28,96,68,0.2916666666666667
DeMar DeRozan,2016.0,51,165,114,0.3090909090909091
DeMar DeRozan,2017.0,34,139,105,0.2446043165467626
DeMar DeRozan,2018.0,99,322,223,0.30745341614906835
DeMar DeRozan,2019.0,7,46,39,0.15217391304347827
DeMar DeRozan,2020.0,9,35,26,0.2571428571428571
DeMar DeRozan,2021.0,19,74,55,0.25675675675675674
DeMar DeRozan,2022.0,50,151,101,0.33112582781456956
DeMar DeRozan,2023.0,46,142,96,0.323943661971831
DeMar DeRozan,2024.0,44,127,83,0.3464566929133858
DeMarcus Cousins,2011.0,3,18,15,0.16666666666666666
DeMarcus Cousins,2012.0,2,14,12,0.14285714285714285
DeMarcus Cousins,2013.0,4,22,18,0.18181818181818182
DeMarcus Cousins,2014.0,0,7,7,0.0
DeMarcus Cousins,2015.0,2,8,6,0.25
DeMarcus Cousins,2016.0,70,210,140,0.3333333333333333
DeMarcus Cousins,2017.0,131,363,232,0.3608815426997245
DeMarcus Cousins,2018.0,104,294,190,0.35374149659863946
DeMarcus Cousins,2019.0,29,107,78,0.27102803738317754
DeMarcus Cousins,2021.0,51,145,94,0.35172413793103446
DeMarcus Cousins,2022.0,41,128,87,0.3203125
DeMarcus Nelson,2009.0,0,3,3,0.0
DeMarre Carroll,2010.0,0,6,6,0.0
DeMarre Carroll,2012.0,8,24,16,0.3333333333333333
DeMarre Carroll,2013.0,20,70,50,0.2857142857142857
DeMarre Carroll,2014.0,106,290,184,0.36551724137931035
DeMarre Carroll,2015.0,149,376,227,0.3962765957446808
DeMarre Carroll,2016.0,72,197,125,0.36548223350253806
DeMarre Carroll,2017.0,116,342,226,0.3391812865497076
DeMarre Carroll,2018.0,145,392,247,0.36989795918367346
DeMarre Carroll,2019.0,113,335,222,0.3373134328358209
DeMarre Carroll,2020.0,8,33,25,0.24242424242424243
DeQuan Jones,2013.0,9,35,26,0.2571428571428571
DeSagana Diop,2005.0,0,2,2,0.0
DeSagana Diop,2006.0,1,2,1,0.5
DeSagana Diop,2007.0,0,1,1,0.0
DeSagana Diop,2013.0,0,1,1,0.0
DeShawn Stevenson,2004.0,19,71,52,0.2676056338028169
DeShawn Stevenson,2005.0,25,67,42,0.373134328358209
DeShawn Stevenson,2006.0,2,15,13,0.13333333333333333
DeShawn Stevenson,2007.0,77,202,125,0.3811881188118812
DeShawn Stevenson,2008.0,172,449,277,0.3830734966592428
DeShawn Stevenson,2009.0,35,129,94,0.2713178294573643
DeShawn Stevenson,2010.0,19,90,71,0.2111111111111111
DeShawn Stevenson,2011.0,121,317,196,0.38170347003154576
DeShawn Stevenson,2012.0,41,145,104,0.2827586206896552
DeShawn Stevenson,2013.0,79,214,135,0.3691588785046729
DeVaughn Akoon-Purcell,2019.0,0,4,4,0.0
Dean Wade,2020.0,2,4,2,0.5
Dean Wade,2021.0,78,213,135,0.36619718309859156
Dean Wade,2022.0,51,142,91,0.3591549295774648
Dean Wade,2023.0,45,128,83,0.3515625
Dean Wade,2024.0,57,138,81,0.41304347826086957
Deandre Ayton,2019.0,0,4,4,0.0
Deandre Ayton,2020.0,3,13,10,0.23076923076923078
Deandre Ayton,2021.0,4,20,16,0.2
Deandre Ayton,2022.0,9,23,14,0.391304347826087
Deandre Ayton,2023.0,7,24,17,0.2916666666666667
Dee Brown,2007.0,6,34,28,0.17647058823529413
Dee Brown,2009.0,7,24,17,0.2916666666666667
Deividas Sirvydis,2021.0,10,28,18,0.35714285714285715
Deividas Sirvydis,2022.0,1,7,6,0.14285714285714285
Dejounte Murray,2017.0,9,26,17,0.34615384615384615
Dejounte Murray,2018.0,13,40,27,0.325
Dejounte Murray,2020.0,41,111,70,0.36936936936936937
Dejounte Murray,2021.0,63,202,139,0.3118811881188119
Dejounte Murray,2022.0,97,299,202,0.32441471571906355
Dejounte Murray,2023.0,147,424,277,0.3466981132075472
Dejounte Murray,2024.0,108,278,170,0.38848920863309355
Delon Wright,2016.0,5,14,9,0.35714285714285715
Delon Wright,2017.0,12,36,24,0.3333333333333333
Delon Wright,2018.0,65,175,110,0.37142857142857144
Delon Wright,2019.0,50,168,118,0.2976190476190476
Delon Wright,2020.0,48,130,82,0.36923076923076925
Delon Wright,2021.0,64,172,108,0.37209302325581395
Delon Wright,2022.0,50,132,82,0.3787878787878788
Delon Wright,2023.0,40,119,79,0.33613445378151263
Delon Wright,2024.0,11,30,19,0.36666666666666664
Delonte West,2005.0,29,78,49,0.3717948717948718
Delonte West,2006.0,84,218,134,0.3853211009174312
Delonte West,2007.0,65,178,113,0.3651685393258427
Delonte West,2008.0,66,177,111,0.3728813559322034
Delonte West,2009.0,103,264,161,0.39015151515151514
Delonte West,2010.0,28,96,68,0.2916666666666667
Delonte West,2011.0,19,52,33,0.36538461538461536
Delonte West,2012.0,30,82,52,0.36585365853658536
Demetris Nichols,2008.0,3,13,10,0.23076923076923078
Demetris Nichols,2009.0,0,2,2,0.0
Demetrius Jackson,2017.0,1,1,0,1.0
Demetrius Jackson,2018.0,1,7,6,0.14285714285714285
Demetrius Jackson,2019.0,2,6,4,0.3333333333333333
Deng Adel,2019.0,6,23,17,0.2608695652173913
Deni Avdija,2021.0,53,168,115,0.31547619047619047
Deni Avdija,2022.0,82,259,177,0.3166023166023166
Deni Avdija,2023.0,69,232,163,0.2974137931034483
Deni Avdija,2024.0,45,119,74,0.37815126050420167
Dennis Horner,2012.0,0,1,1,0.0
Dennis Schroder,2014.0,11,43,32,0.2558139534883721
Dennis Schroder,2015.0,60,182,122,0.32967032967032966
Dennis Schroder,2016.0,89,274,185,0.3248175182481752
Dennis Schroder,2017.0,117,335,218,0.3492537313432836
Dennis Schroder,2018.0,76,262,186,0.2900763358778626
Dennis Schroder,2019.0,130,384,254,0.3385416666666667
Dennis Schroder,2020.0,138,370,232,0.372972972972973
Dennis Schroder,2021.0,80,244,164,0.32786885245901637
Dennis Schroder,2022.0,86,250,164,0.344
Dennis Schroder,2023.0,87,264,177,0.32954545454545453
Dennis Schroder,2024.0,71,200,129,0.355
Dennis Smith,2018.0,106,339,233,0.31268436578171094
Dennis Smith,2019.0,67,208,141,0.32211538461538464
Dennis Smith,2020.0,16,54,38,0.2962962962962963
Dennis Smith,2021.0,19,59,40,0.3220338983050847
Dennis Smith,2022.0,6,27,21,0.2222222222222222
Dennis Smith,2023.0,24,111,87,0.21621621621621623
Dennis Smith,2024.0,16,57,41,0.2807017543859649
Denzel Valentine,2017.0,74,212,138,0.3490566037735849
Denzel Valentine,2018.0,143,370,227,0.3864864864864865
Denzel Valentine,2020.0,46,137,91,0.3357664233576642
Denzel Valentine,2021.0,80,242,162,0.3305785123966942
Denzel Valentine,2022.0,19,47,28,0.40425531914893614
Deonte Burton,2019.0,8,29,21,0.27586206896551724
Deonte Burton,2020.0,10,53,43,0.18867924528301888
Deonte Burton,2023.0,0,1,1,0.0
DerMarr Johnson,2004.0,13,39,26,0.3333333333333333
DerMarr Johnson,2005.0,57,159,102,0.3584905660377358
DerMarr Johnson,2006.0,57,170,113,0.3352941176470588
DerMarr Johnson,2007.0,19,88,69,0.2159090909090909
DerMarr Johnson,2008.0,3,9,6,0.3333333333333333
Dereck Lively,2024.0,0,1,1,0.0
Derek Anderson,2004.0,79,259,180,0.305019305019305
Derek Anderson,2005.0,58,151,93,0.3841059602649007
Derek Anderson,2006.0,45,148,103,0.30405405405405406
Derek Anderson,2007.0,54,152,98,0.35526315789473684
Derek Anderson,2008.0,19,52,33,0.36538461538461536
Derek Fisher,2004.0,74,229,155,0.3231441048034934
Derek Fisher,2005.0,108,291,183,0.3711340206185567
Derek Fisher,2006.0,117,295,178,0.39661016949152544
Derek Fisher,2007.0,60,188,128,0.3191489361702128
Derek Fisher,2008.0,134,326,192,0.4110429447852761
Derek Fisher,2009.0,139,369,230,0.37669376693766937
Derek Fisher,2010.0,105,299,194,0.3511705685618729
Derek Fisher,2011.0,70,176,106,0.3977272727272727
Derek Fisher,2012.0,53,157,104,0.3375796178343949
Derek Fisher,2013.0,54,131,77,0.4122137404580153
Derek Fisher,2014.0,100,270,170,0.37037037037037035
Dereon Seabron,2024.0,1,2,1,0.5
Deron Williams,2006.0,91,219,128,0.4155251141552511
Deron Williams,2007.0,101,312,211,0.32371794871794873
Deron Williams,2008.0,111,266,155,0.41729323308270677
Deron Williams,2009.0,79,251,172,0.3147410358565737
Deron Williams,2010.0,116,310,194,0.3741935483870968
Deron Williams,2011.0,105,317,212,0.3312302839116719
Deron Williams,2012.0,115,342,227,0.3362573099415205
Deron Williams,2013.0,186,490,304,0.3795918367346939
Deron Williams,2014.0,116,321,205,0.3613707165109034
Deron Williams,2015.0,98,263,165,0.3726235741444867
Deron Williams,2016.0,100,289,189,0.3460207612456747
Deron Williams,2017.0,97,265,168,0.3660377358490566
Derrick Brown,2010.0,2,7,5,0.2857142857142857
Derrick Brown,2011.0,5,10,5,0.5
Derrick Brown,2012.0,6,24,18,0.25
Derrick Byars,2012.0,0,6,6,0.0
Derrick Coleman,2004.0,7,34,27,0.20588235294117646
Derrick Coleman,2005.0,0,2,2,0.0
Derrick Dial,2004.0,2,9,7,0.2222222222222222
Derrick Favors,2013.0,0,5,5,0.0
Derrick Favors,2014.0,0,1,1,0.0
Derrick Favors,2015.0,1,6,5,0.16666666666666666
Derrick Favors,2016.0,0,4,4,0.0
Derrick Favors,2017.0,3,10,7,0.3
Derrick Favors,2018.0,16,68,52,0.23529411764705882
Derrick Favors,2019.0,17,81,64,0.20987654320987653
Derrick Favors,2020.0,1,7,6,0.14285714285714285
Derrick Favors,2021.0,0,2,2,0.0
Derrick Favors,2022.0,2,16,14,0.125
Derrick Jones,2017.0,3,11,8,0.2727272727272727
Derrick Jones,2018.0,3,18,15,0.16666666666666666
Derrick Jones,2019.0,28,91,63,0.3076923076923077
Derrick Jones,2020.0,41,141,100,0.2907801418439716
Derrick Jones,2021.0,43,138,95,0.3115942028985507
Derrick Jones,2022.0,23,72,49,0.3194444444444444
Derrick Jones,2023.0,27,80,53,0.3375
Derrick Jones,2024.0,59,169,110,0.34911242603550297
Derrick Rose,2009.0,16,76,60,0.21052631578947367
Derrick Rose,2010.0,18,66,48,0.2727272727272727
Derrick Rose,2011.0,153,486,333,0.3148148148148148
Derrick Rose,2012.0,57,179,122,0.31843575418994413
Derrick Rose,2014.0,16,47,31,0.3404255319148936
Derrick Rose,2015.0,99,337,238,0.29376854599406527
Derrick Rose,2016.0,44,150,106,0.29333333333333333
Derrick Rose,2017.0,13,60,47,0.21666666666666667
Derrick Rose,2018.0,14,40,26,0.35
Derrick Rose,2019.0,54,146,92,0.3698630136986301
Derrick Rose,2020.0,45,147,102,0.30612244897959184
Derrick Rose,2021.0,58,146,88,0.3972602739726027
Derrick Rose,2022.0,37,92,55,0.40217391304347827
Derrick Rose,2023.0,19,64,45,0.296875
Derrick Rose,2024.0,11,33,22,0.3333333333333333
Derrick Walton,2018.0,7,17,10,0.4117647058823529
Derrick Walton,2020.0,10,24,14,0.4166666666666667
Derrick Walton,2022.0,3,13,10,0.23076923076923078
Derrick White,2018.0,9,15,6,0.6
Derrick White,2019.0,53,159,106,0.3333333333333333
Derrick White,2020.0,79,216,137,0.36574074074074076
Derrick White,2021.0,84,243,159,0.345679012345679
Derrick White,2022.0,141,452,311,0.31194690265486724
Derrick White,2023.0,199,501,302,0.3972055888223553
Derrick White,2024.0,110,278,168,0.39568345323741005
Derrick Williams,2012.0,37,138,101,0.26811594202898553
Derrick Williams,2013.0,65,196,131,0.33163265306122447
Derrick Williams,2014.0,26,99,73,0.26262626262626265
Derrick Williams,2015.0,49,156,107,0.3141025641025641
Derrick Williams,2016.0,44,150,106,0.29333333333333333
Derrick Williams,2017.0,33,102,69,0.3235294117647059
Derrick Williams,2018.0,0,2,2,0.0
Desmon Farmer,2007.0,2,8,6,0.25
Desmon Farmer,2009.0,3,12,9,0.25
Desmond Bane,2021.0,124,290,166,0.42758620689655175
Desmond Bane,2022.0,271,612,341,0.44281045751633985
Desmond Bane,2023.0,182,457,275,0.3982494529540481
Desmond Bane,2024.0,123,320,197,0.384375
Desmond Ferguson,2004.0,3,8,5,0.375
Desmond Mason,2004.0,9,41,32,0.21951219512195122
Desmond Mason,2005.0,1,8,7,0.125
Desmond Mason,2006.0,1,6,5,0.16666666666666666
Desmond Mason,2009.0,0,3,3,0.0
Devean George,2004.0,85,242,157,0.3512396694214876
Devean George,2005.0,21,58,37,0.3620689655172414
Devean George,2006.0,59,181,122,0.3259668508287293
Devean George,2007.0,56,162,106,0.345679012345679
Devean George,2008.0,26,80,54,0.325
Devean George,2009.0,22,76,54,0.2894736842105263
Devean George,2010.0,48,123,75,0.3902439024390244
Devin Booker,2016.0,99,289,190,0.34256055363321797
Devin Booker,2017.0,147,405,258,0.362962962962963
Devin Booker,2018.0,147,384,237,0.3828125
Devin Booker,2019.0,135,414,279,0.32608695652173914
Devin Booker,2020.0,141,398,257,0.3542713567839196
Devin Booker,2021.0,170,508,338,0.3346456692913386
Devin Booker,2022.0,211,543,332,0.3885819521178637
Devin Booker,2023.0,142,377,235,0.376657824933687
Devin Booker,2024.0,84,216,132,0.3888888888888889
Devin Brown,2004.0,10,24,14,0.4166666666666667
Devin Brown,2005.0,48,128,80,0.375
Devin Brown,2006.0,39,118,79,0.3305084745762712
Devin Brown,2007.0,81,227,146,0.3568281938325991
Devin Brown,2008.0,50,163,113,0.3067484662576687
Devin Brown,2009.0,28,101,73,0.27722772277227725
Devin Brown,2010.0,58,164,106,0.35365853658536583
Devin Cannady,2021.0,6,16,10,0.375
Devin Cannady,2022.0,15,37,22,0.40540540540540543
Devin Ebanks,2011.0,2,5,3,0.4
Devin Ebanks,2012.0,0,12,12,0.0
Devin Ebanks,2013.0,6,22,16,0.2727272727272727
Devin Green,2006.0,0,2,2,0.0
Devin Harris,2005.0,46,137,91,0.3357664233576642
Devin Harris,2006.0,5,29,24,0.1724137931034483
Devin Harris,2007.0,17,60,43,0.2833333333333333
Devin Harris,2008.0,56,167,111,0.33532934131736525
Devin Harris,2009.0,64,220,156,0.2909090909090909
Devin Harris,2010.0,60,217,157,0.2764976958525346
Devin Harris,2011.0,58,180,122,0.32222222222222224
Devin Harris,2012.0,81,228,147,0.35526315789473684
Devin Harris,2013.0,82,255,173,0.3215686274509804
Devin Harris,2014.0,42,126,84,0.3333333333333333
Devin Harris,2015.0,95,277,182,0.34296028880866425
Devin Harris,2016.0,56,171,115,0.32748538011695905
Devin Harris,2017.0,58,176,118,0.32954545454545453
Devin Harris,2018.0,79,227,148,0.34801762114537443
Devin Harris,2019.0,62,200,138,0.31
Devin Robinson,2019.0,0,2,2,0.0
Devin Vassell,2021.0,52,150,98,0.3466666666666667
Devin Vassell,2022.0,144,393,249,0.366412213740458
Devin Vassell,2023.0,103,266,163,0.38721804511278196
Devin Vassell,2024.0,100,275,175,0.36363636363636365
Devon Dotson,2021.0,1,7,6,0.14285714285714285
Devon Dotson,2022.0,2,9,7,0.2222222222222222
Devon Dotson,2023.0,1,3,2,0.3333333333333333
Devon Hall,2020.0,4,17,13,0.23529411764705882
Devonte' Graham,2019.0,34,121,87,0.2809917355371901
Devonte' Graham,2020.0,218,585,367,0.37264957264957266
Devonte' Graham,2021.0,179,483,304,0.37060041407867494
Devonte' Graham,2022.0,197,579,382,0.34024179620034545
Devonte' Graham,2023.0,119,338,219,0.3520710059171598
Devonte' Graham,2024.0,7,20,13,0.35
Devyn Marble,2015.0,4,22,18,0.18181818181818182
Devyn Marble,2016.0,8,32,24,0.25
Dewan Hernandez,2020.0,1,2,1,0.5
Dewayne Dedmon,2015.0,0,1,1,0.0
Dewayne Dedmon,2018.0,50,141,91,0.3546099290780142
Dewayne Dedmon,2019.0,83,217,134,0.3824884792626728
Dewayne Dedmon,2020.0,22,107,85,0.205607476635514
Dewayne Dedmon,2021.0,2,8,6,0.25
Dewayne Dedmon,2022.0,20,57,37,0.3508771929824561
Dewayne Dedmon,2023.0,12,40,28,0.3
Dexter Dennis,2024.0,3,11,8,0.2727272727272727
Deyonta Davis,2019.0,0,1,1,0.0
Diante Garrett,2013.0,3,15,12,0.2
Diante Garrett,2014.0,36,96,60,0.375
Didi Louzada,2021.0,2,8,6,0.25
Didi Louzada,2022.0,9,23,14,0.391304347826087
Didier Ilunga-Mbenga,2006.0,0,1,1,0.0
Didier Ilunga-Mbenga,2009.0,0,1,1,0.0
Dijon Thompson,2006.0,4,11,7,0.36363636363636365
Dijon Thompson,2007.0,0,2,2,0.0
Dillon Brooks,2018.0,94,264,170,0.3560606060606061
Dillon Brooks,2019.0,15,40,25,0.375
Dillon Brooks,2020.0,151,417,266,0.36211031175059955
Dillon Brooks,2021.0,136,399,263,0.3408521303258145
Dillon Brooks,2022.0,71,221,150,0.3212669683257919
Dillon Brooks,2023.0,153,481,328,0.3180873180873181
Dillon Brooks,2024.0,67,174,107,0.3850574712643678
Dion Glover,2004.0,40,119,79,0.33613445378151263
Dion Glover,2005.0,1,8,7,0.125
Dion Waiters,2013.0,63,203,140,0.3103448275862069
Dion Waiters,2014.0,92,250,158,0.368
Dion Waiters,2015.0,73,246,173,0.2967479674796748
Dion Waiters,2016.0,107,296,189,0.3614864864864865
Dion Waiters,2017.0,85,216,131,0.39351851851851855
Dion Waiters,2018.0,52,170,118,0.3058823529411765
Dion Waiters,2019.0,109,289,180,0.3771626297577855
Dion Waiters,2020.0,15,51,36,0.29411764705882354
Dionte Christmas,2014.0,9,31,22,0.2903225806451613
Dirk Nowitzki,2004.0,106,299,193,0.35451505016722407
Dirk Nowitzki,2005.0,101,258,157,0.39147286821705424
Dirk Nowitzki,2006.0,133,338,205,0.39349112426035504
Dirk Nowitzki,2007.0,76,192,116,0.3958333333333333
Dirk Nowitzki,2008.0,85,238,153,0.35714285714285715
Dirk Nowitzki,2009.0,67,191,124,0.3507853403141361
Dirk Nowitzki,2010.0,55,128,73,0.4296875
Dirk Nowitzki,2011.0,89,218,129,0.40825688073394495
Dirk Nowitzki,2012.0,79,218,139,0.3623853211009174
Dirk Nowitzki,2013.0,65,157,92,0.4140127388535032
Dirk Nowitzki,2014.0,132,341,209,0.3870967741935484
Dirk Nowitzki,2015.0,108,291,183,0.3711340206185567
Dirk Nowitzki,2016.0,130,353,223,0.36827195467422097
Dirk Nowitzki,2017.0,79,209,130,0.37799043062200954
Dirk Nowitzki,2018.0,138,337,199,0.4094955489614243
Dirk Nowitzki,2019.0,64,205,141,0.3121951219512195
Dmytro Skapintsev,2024.0,1,3,2,0.3333333333333333
Domantas Sabonis,2017.0,51,160,109,0.31875
Domantas Sabonis,2018.0,14,44,30,0.3181818181818182
Domantas Sabonis,2019.0,10,21,11,0.47619047619047616
Domantas Sabonis,2020.0,17,67,50,0.2537313432835821
Domantas Sabonis,2021.0,52,163,111,0.31901840490797545
Domantas Sabonis,2022.0,39,126,87,0.30952380952380953
Domantas Sabonis,2023.0,32,88,56,0.36363636363636365
Domantas Sabonis,2024.0,22,50,28,0.44
Dominic McGuire,2008.0,1,6,5,0.16666666666666666
Dominic McGuire,2009.0,2,4,2,0.5
Dominic McGuire,2011.0,0,2,2,0.0
Dominic McGuire,2012.0,0,4,4,0.0
Dominick Barlow,2023.0,0,4,4,0.0
Dominick Barlow,2024.0,3,7,4,0.42857142857142855
Dominique Jones,2011.0,0,4,4,0.0
Dominique Jones,2012.0,1,8,7,0.125
Dominique Jones,2013.0,1,9,8,0.1111111111111111
Donald Sloan,2012.0,2,25,23,0.08
Donald Sloan,2013.0,7,19,12,0.3684210526315789
Donald Sloan,2014.0,11,46,35,0.2391304347826087
Donald Sloan,2015.0,41,131,90,0.31297709923664124
Donald Sloan,2016.0,38,99,61,0.3838383838383838
Donatas Motiejunas,2013.0,24,83,59,0.2891566265060241
Donatas Motiejunas,2014.0,21,84,63,0.25
Donatas Motiejunas,2015.0,49,133,84,0.3684210526315789
Donatas Motiejunas,2016.0,20,66,46,0.30303030303030304
Donatas Motiejunas,2017.0,11,47,36,0.23404255319148937
Donatas Motiejunas,2019.0,0,1,1,0.0
Donell Taylor,2006.0,4,18,14,0.2222222222222222
Donell Taylor,2007.0,3,17,14,0.17647058823529413
Donnell Harvey,2004.0,0,3,3,0.0
Donovan Mitchell,2018.0,212,630,418,0.33650793650793653
Donovan Mitchell,2019.0,199,563,364,0.35346358792184723
Donovan Mitchell,2020.0,206,537,331,0.38361266294227186
Donovan Mitchell,2021.0,228,576,348,0.3958333333333333
Donovan Mitchell,2022.0,242,702,460,0.34472934472934474
Donovan Mitchell,2023.0,258,679,421,0.3799705449189985
Donovan Mitchell,2024.0,107,307,200,0.3485342019543974
Donovan Williams,2023.0,0,2,2,0.0
Donta Smith,2005.0,6,22,16,0.2727272727272727
Donta Smith,2006.0,2,4,2,0.5
Donte DiVincenzo,2019.0,22,83,61,0.26506024096385544
Donte DiVincenzo,2020.0,90,268,178,0.3358208955223881
Donte DiVincenzo,2021.0,133,358,225,0.3715083798882682
Donte DiVincenzo,2022.0,74,218,144,0.3394495412844037
Donte DiVincenzo,2023.0,165,422,257,0.3909952606635071
Donte DiVincenzo,2024.0,122,289,167,0.42214532871972316
Donte Grantham,2019.0,0,2,2,0.0
Donte Greene,2009.0,26,100,74,0.26
Donte Greene,2010.0,69,183,114,0.3770491803278688
Donte Greene,2011.0,45,154,109,0.2922077922077922
Donte Greene,2012.0,25,105,80,0.23809523809523808
Dontell Jefferson,2009.0,1,2,1,0.5
Donyell Marshall,2004.0,131,325,194,0.40307692307692305
Donyell Marshall,2005.0,151,363,212,0.41597796143250687
Donyell Marshall,2006.0,146,441,295,0.3310657596371882
Donyell Marshall,2007.0,109,316,207,0.3449367088607595
Donyell Marshall,2008.0,15,53,38,0.2830188679245283
Donyell Marshall,2009.0,29,66,37,0.4393939393939394
Dorell Wright,2005.0,0,4,4,0.0
Dorell Wright,2006.0,3,6,3,0.5
Dorell Wright,2007.0,5,34,29,0.14705882352941177
Dorell Wright,2008.0,4,11,7,0.36363636363636365
Dorell Wright,2010.0,63,165,102,0.38181818181818183
Dorell Wright,2011.0,194,516,322,0.375968992248062
Dorell Wright,2012.0,105,292,187,0.3595890410958904
Dorell Wright,2013.0,135,361,226,0.3739612188365651
Dorell Wright,2014.0,73,214,141,0.3411214953271028
Dorell Wright,2015.0,41,108,67,0.37962962962962965
Dorell Wright,2016.0,2,5,3,0.4
Dorian Finney-Smith,2017.0,56,191,135,0.2931937172774869
Dorian Finney-Smith,2018.0,20,67,47,0.29850746268656714
Dorian Finney-Smith,2019.0,79,254,175,0.3110236220472441
Dorian Finney-Smith,2020.0,125,333,208,0.37537537537537535
Dorian Finney-Smith,2021.0,135,339,204,0.39823008849557523
Dorian Finney-Smith,2022.0,218,543,325,0.4014732965009208
Dorian Finney-Smith,2023.0,121,355,234,0.3408450704225352
Dorian Finney-Smith,2024.0,88,230,142,0.3826086956521739
Doron Lamb,2013.0,14,37,23,0.3783783783783784
Doron Lamb,2014.0,36,90,54,0.4
Doug Christie,2004.0,62,175,113,0.35428571428571426
Doug Christie,2005.0,15,62,47,0.24193548387096775
Doug Christie,2006.0,0,1,1,0.0
Doug Christie,2007.0,1,6,5,0.16666666666666666
Doug McDermott,2015.0,14,43,29,0.32558139534883723
Doug McDermott,2016.0,110,259,149,0.4247104247104247
Doug McDermott,2017.0,84,221,137,0.38009049773755654
Doug McDermott,2018.0,92,216,124,0.42592592592592593
Doug McDermott,2019.0,84,213,129,0.39436619718309857
Doug McDermott,2020.0,130,304,174,0.4276315789473684
Doug McDermott,2021.0,116,292,176,0.3972602739726027
Doug McDermott,2022.0,108,256,148,0.421875
Doug McDermott,2023.0,123,298,175,0.412751677852349
Doug McDermott,2024.0,69,154,85,0.44805194805194803
Doug Overton,2004.0,3,23,20,0.13043478260869565
Dragan Bender,2017.0,28,101,73,0.27722772277227725
Dragan Bender,2018.0,118,322,204,0.36645962732919257
Dragan Bender,2019.0,22,101,79,0.21782178217821782
Dragan Bender,2020.0,15,43,28,0.3488372093023256
Draymond Green,2013.0,23,90,67,0.25555555555555554
Draymond Green,2014.0,63,194,131,0.3247422680412371
Draymond Green,2015.0,135,420,285,0.32142857142857145
Draymond Green,2016.0,138,362,224,0.3812154696132597
Draymond Green,2017.0,113,342,229,0.3304093567251462
Draymond Green,2018.0,98,335,237,0.29253731343283584
Draymond Green,2019.0,60,222,162,0.2702702702702703
Draymond Green,2020.0,36,129,93,0.27906976744186046
Draymond Green,2021.0,35,128,93,0.2734375
Draymond Green,2022.0,24,93,69,0.25806451612903225
Draymond Green,2023.0,45,151,106,0.2980132450331126
Draymond Green,2024.0,21,51,30,0.4117647058823529
Drew Eubanks,2020.0,1,1,0,1.0
Drew Eubanks,2021.0,2,2,0,1.0
Drew Eubanks,2022.0,5,23,18,0.21739130434782608
Drew Eubanks,2023.0,7,18,11,0.3888888888888889
Drew Eubanks,2024.0,3,3,0,1.0
Drew Gooden,2004.0,9,42,33,0.21428571428571427
Drew Gooden,2005.0,5,28,23,0.17857142857142858
Drew Gooden,2006.0,1,3,2,0.3333333333333333
Drew Gooden,2007.0,1,8,7,0.125
Drew Gooden,2008.0,0,6,6,0.0
Drew Gooden,2009.0,0,6,6,0.0
Drew Gooden,2010.0,1,8,7,0.125
Drew Gooden,2011.0,3,20,17,0.15
Drew Gooden,2012.0,16,55,39,0.2909090909090909
Drew Gooden,2013.0,1,5,4,0.2
Drew Gooden,2014.0,7,21,14,0.3333333333333333
Drew Gooden,2015.0,35,85,50,0.4117647058823529
Drew Gooden,2016.0,7,41,34,0.17073170731707318
Drew Gordon,2015.0,0,3,3,0.0
Drew Peterson,2024.0,1,1,0,1.0
Dru Smith,2023.0,5,19,14,0.2631578947368421
Dru Smith,2024.0,7,17,10,0.4117647058823529
Duane Washington,2022.0,81,215,134,0.3767441860465116
Duane Washington,2023.0,40,111,71,0.36036036036036034
Duje Dukan,2016.0,2,5,3,0.4
Duncan Robinson,2019.0,10,35,25,0.2857142857142857
Duncan Robinson,2020.0,332,762,430,0.4356955380577428
Duncan Robinson,2021.0,260,640,380,0.40625
Duncan Robinson,2022.0,250,671,421,0.37257824143070045
Duncan Robinson,2023.0,113,305,192,0.3704918032786885
Duncan Robinson,2024.0,124,306,182,0.40522875816993464
Duop Reath,2024.0,47,132,85,0.3560606060606061
Dusty Hannahs,2019.0,0,5,5,0.0
Dusty Hannahs,2020.0,2,3,1,0.6666666666666666
Dwayne Bacon,2018.0,11,43,32,0.2558139534883721
Dwayne Bacon,2019.0,38,87,49,0.4367816091954023
Dwayne Bacon,2020.0,19,67,48,0.2835820895522388
Dwayne Bacon,2021.0,59,206,147,0.28640776699029125
Dwayne Jones,2008.0,0,1,1,0.0
Dwight Buycks,2014.0,5,17,12,0.29411764705882354
Dwight Buycks,2015.0,7,11,4,0.6363636363636364
Dwight Buycks,2018.0,15,45,30,0.3333333333333333
Dwight Howard,2005.0,0,2,2,0.0
Dwight Howard,2006.0,0,2,2,0.0
Dwight Howard,2007.0,1,2,1,0.5
Dwight Howard,2008.0,0,4,4,0.0
Dwight Howard,2009.0,0,4,4,0.0
Dwight Howard,2010.0,0,7,7,0.0
Dwight Howard,2011.0,0,8,8,0.0
Dwight Howard,2012.0,0,7,7,0.0
Dwight Howard,2013.0,1,6,5,0.16666666666666666
Dwight Howard,2014.0,2,7,5,0.2857142857142857
Dwight Howard,2015.0,1,2,1,0.5
Dwight Howard,2016.0,0,7,7,0.0
Dwight Howard,2017.0,0,2,2,0.0
Dwight Howard,2018.0,1,7,6,0.14285714285714285
Dwight Howard,2020.0,4,7,3,0.5714285714285714
Dwight Howard,2021.0,5,21,16,0.23809523809523808
Dwight Howard,2022.0,8,15,7,0.5333333333333333
Dwight Powell,2015.0,3,11,8,0.2727272727272727
Dwight Powell,2016.0,2,17,15,0.11764705882352941
Dwight Powell,2017.0,21,74,53,0.28378378378378377
Dwight Powell,2018.0,28,84,56,0.3333333333333333
Dwight Powell,2019.0,39,127,88,0.30708661417322836
Dwight Powell,2020.0,10,39,29,0.2564102564102564
Dwight Powell,2021.0,5,21,16,0.23809523809523808
Dwight Powell,2022.0,13,39,26,0.3333333333333333
Dwight Powell,2023.0,0,5,5,0.0
Dwight Powell,2024.0,1,2,1,0.5
Dwyane Wade,2004.0,18,58,40,0.3103448275862069
Dwyane Wade,2005.0,14,55,41,0.2545454545454545
Dwyane Wade,2006.0,27,113,86,0.23893805309734514
Dwyane Wade,2007.0,21,84,63,0.25
Dwyane Wade,2008.0,22,77,55,0.2857142857142857
Dwyane Wade,2009.0,106,328,222,0.3231707317073171
Dwyane Wade,2010.0,88,280,192,0.3142857142857143
Dwyane Wade,2011.0,77,258,181,0.29844961240310075
Dwyane Wade,2012.0,25,90,65,0.2777777777777778
Dwyane Wade,2013.0,18,70,52,0.2571428571428571
Dwyane Wade,2014.0,18,56,38,0.32142857142857145
Dwyane Wade,2015.0,29,102,73,0.28431372549019607
Dwyane Wade,2016.0,19,67,48,0.2835820895522388
Dwyane Wade,2017.0,51,163,112,0.3128834355828221
Dwyane Wade,2018.0,32,115,83,0.2782608695652174
Dwyane Wade,2019.0,86,261,175,0.32950191570881227
Dylan Windler,2021.0,26,78,52,0.3333333333333333
Dylan Windler,2022.0,21,70,49,0.3
Dylan Windler,2023.0,1,2,1,0.5
Dylan Windler,2024.0,2,3,1,0.6666666666666666
Dyson Daniels,2023.0,27,86,59,0.313953488372093
Dyson Daniels,2024.0,28,99,71,0.2828282828282828
Dzanan Musa,2019.0,1,11,10,0.09090909090909091
Dzanan Musa,2020.0,19,84,65,0.2261904761904762
E'Twaun Moore,2012.0,17,47,30,0.3617021276595745
E'Twaun Moore,2013.0,67,197,130,0.3401015228426396
E'Twaun Moore,2014.0,57,161,104,0.35403726708074534
E'Twaun Moore,2015.0,14,39,25,0.358974358974359
E'Twaun Moore,2016.0,47,104,57,0.4519230769230769
E'Twaun Moore,2017.0,77,208,131,0.3701923076923077
E'Twaun Moore,2018.0,137,326,189,0.42024539877300615
E'Twaun Moore,2019.0,76,176,100,0.4318181818181818
E'Twaun Moore,2020.0,63,167,104,0.3772455089820359
E'Twaun Moore,2021.0,12,40,28,0.3
E.J. Liddell,2024.0,0,5,5,0.0
Earl Barron,2007.0,0,1,1,0.0
Earl Barron,2008.0,1,13,12,0.07692307692307693
Earl Barron,2015.0,2,4,2,0.5
Earl Boykins,2004.0,60,185,125,0.32432432432432434
Earl Boykins,2005.0,56,173,117,0.3236994219653179
Earl Boykins,2006.0,66,198,132,0.3333333333333333
Earl Boykins,2007.0,95,239,144,0.39748953974895396
Earl Boykins,2008.0,14,44,30,0.3181818181818182
Earl Boykins,2010.0,19,60,41,0.31666666666666665
Earl Boykins,2011.0,27,71,44,0.38028169014084506
Earl Boykins,2012.0,2,9,7,0.2222222222222222
Earl Clark,2010.0,2,5,3,0.4
Earl Clark,2011.0,0,5,5,0.0
Earl Clark,2013.0,35,108,73,0.32407407407407407
Earl Clark,2014.0,41,122,81,0.3360655737704918
Earl Clark,2015.0,6,17,11,0.35294117647058826
Earl Watson,2004.0,26,109,83,0.23853211009174313
Earl Watson,2005.0,53,172,119,0.3081395348837209
Earl Watson,2006.0,110,272,162,0.40441176470588236
Earl Watson,2007.0,92,280,188,0.32857142857142857
Earl Watson,2008.0,49,132,83,0.3712121212121212
Earl Watson,2009.0,20,85,65,0.23529411764705882
Earl Watson,2010.0,53,184,131,0.28804347826086957
Earl Watson,2011.0,36,107,71,0.3364485981308411
Earl Watson,2012.0,10,52,42,0.19230769230769232
Earl Watson,2013.0,5,28,23,0.17857142857142858
Earl Watson,2014.0,2,8,6,0.25
Ed Davis,2012.0,0,1,1,0.0
Ed Davis,2016.0,0,2,2,0.0
Ed Davis,2018.0,0,1,1,0.0
Ed Davis,2019.0,0,2,2,0.0
Eddie Basden,2006.0,1,7,6,0.14285714285714285
Eddie Gill,2004.0,3,8,5,0.375
Eddie Gill,2005.0,37,123,86,0.3008130081300813
Eddie Gill,2006.0,7,23,16,0.30434782608695654
Eddie Gill,2008.0,5,15,10,0.3333333333333333
Eddie Gill,2009.0,2,3,1,0.6666666666666666
Eddie Griffin,2005.0,67,204,137,0.3284313725490196
Eddie Griffin,2006.0,16,82,66,0.1951219512195122
Eddie Griffin,2007.0,0,1,1,0.0
Eddie House,2004.0,51,136,85,0.375
Eddie House,2005.0,45,98,53,0.45918367346938777
Eddie House,2006.0,126,330,204,0.38181818181818183
Eddie House,2007.0,76,181,105,0.4198895027624309
Eddie House,2008.0,128,329,201,0.3890577507598784
Eddie House,2009.0,169,377,208,0.4482758620689655
Eddie House,2010.0,79,227,148,0.34801762114537443
Eddie House,2011.0,71,185,114,0.3837837837837838
Eddie Jones,2004.0,193,535,342,0.36074766355140186
Eddie Jones,2005.0,174,462,288,0.37662337662337664
Eddie Jones,2006.0,136,381,245,0.3569553805774278
Eddie Jones,2007.0,79,228,149,0.34649122807017546
Eddie Jones,2008.0,35,120,85,0.2916666666666667
Eddie Robinson,2004.0,1,5,4,0.2
Eddy Curry,2004.0,1,1,0,1.0
Eddy Curry,2007.0,1,1,0,1.0
Edmond Sumner,2019.0,7,27,20,0.25925925925925924
Edmond Sumner,2020.0,14,56,42,0.25
Edmond Sumner,2021.0,36,88,52,0.4090909090909091
Edmond Sumner,2023.0,31,87,56,0.3563218390804598
Eduardo Najera,2004.0,2,4,2,0.5
Eduardo Najera,2005.0,6,21,15,0.2857142857142857
Eduardo Najera,2006.0,4,12,8,0.3333333333333333
Eduardo Najera,2007.0,1,15,14,0.06666666666666667
Eduardo Najera,2008.0,55,152,97,0.3618421052631579
Eduardo Najera,2009.0,5,25,20,0.2
Eduardo Najera,2010.0,19,69,50,0.2753623188405797
Eduardo Najera,2011.0,11,34,23,0.3235294117647059
Eduardo Najera,2012.0,8,29,21,0.27586206896551724
Edwin Ubiles,2012.0,1,5,4,0.2
Ekpe Udoh,2012.0,0,2,2,0.0
Ekpe Udoh,2013.0,0,1,1,0.0
Ekpe Udoh,2018.0,0,1,1,0.0
Elden Campbell,2005.0,0,2,2,0.0
Elfrid Payton,2015.0,11,42,31,0.2619047619047619
Elfrid Payton,2016.0,30,92,62,0.32608695652173914
Elfrid Payton,2017.0,40,146,106,0.273972602739726
Elfrid Payton,2018.0,30,92,62,0.32608695652173914
Elfrid Payton,2019.0,33,105,72,0.3142857142857143
Elfrid Payton,2020.0,14,69,55,0.2028985507246377
Elfrid Payton,2021.0,28,98,70,0.2857142857142857
Elfrid Payton,2022.0,4,18,14,0.2222222222222222
Elie Okobo,2019.0,39,132,93,0.29545454545454547
Elie Okobo,2020.0,25,71,46,0.352112676056338
Elijah Hughes,2021.0,8,23,15,0.34782608695652173
Elijah Hughes,2022.0,25,95,70,0.2631578947368421
Elijah Millsap,2015.0,28,90,62,0.3111111111111111
Elijah Millsap,2016.0,1,12,11,0.08333333333333333
Elijah Millsap,2017.0,0,2,2,0.0
Elliot Williams,2012.0,8,27,19,0.2962962962962963
Elliot Williams,2014.0,37,125,88,0.296
Elliot Williams,2015.0,8,18,10,0.4444444444444444
Elliot Williams,2016.0,1,4,3,0.25
Elton Brand,2004.0,0,1,1,0.0
Elton Brand,2005.0,0,3,3,0.0
Elton Brand,2006.0,1,4,3,0.25
Elton Brand,2007.0,1,1,0,1.0
Elton Brand,2010.0,0,1,1,0.0
Elton Brand,2011.0,0,1,1,0.0
Elton Brand,2012.0,0,1,1,0.0
Elton Brand,2013.0,0,1,1,0.0
Elton Brand,2014.0,0,2,2,0.0
Elton Brand,2015.0,0,1,1,0.0
Elton Brand,2016.0,0,1,1,0.0
Emeka Okafor,2005.0,0,1,1,0.0
Emeka Okafor,2011.0,0,1,1,0.0
Emmanuel Mudiay,2016.0,74,232,158,0.31896551724137934
Emmanuel Mudiay,2017.0,56,177,121,0.3163841807909605
Emmanuel Mudiay,2018.0,47,147,100,0.3197278911564626
Emmanuel Mudiay,2019.0,69,209,140,0.33014354066985646
Emmanuel Mudiay,2020.0,32,90,58,0.35555555555555557
Emoni Bates,2024.0,3,14,11,0.21428571428571427
Enes Kanter,2012.0,0,1,1,0.0
Enes Kanter,2013.0,1,1,0,1.0
Enes Kanter,2014.0,0,1,1,0.0
Enes Kanter,2015.0,16,45,29,0.35555555555555557
Enes Kanter,2016.0,12,35,23,0.34285714285714286
Enes Kanter,2017.0,5,38,33,0.13157894736842105
Enes Kanter,2018.0,0,2,2,0.0
Enes Kanter,2019.0,11,38,27,0.2894736842105263
Enes Kanter,2020.0,2,8,6,0.25
Enes Kanter,2021.0,1,4,3,0.25
Enes Kanter,2022.0,2,5,3,0.4
Eric Bledsoe,2011.0,32,116,84,0.27586206896551724
Eric Bledsoe,2012.0,9,37,28,0.24324324324324326
Eric Bledsoe,2013.0,32,87,55,0.367816091954023
Eric Bledsoe,2014.0,50,140,90,0.35714285714285715
Eric Bledsoe,2015.0,88,272,184,0.3235294117647059
Eric Bledsoe,2016.0,48,129,81,0.37209302325581395
Eric Bledsoe,2017.0,104,309,205,0.3365695792880259
Eric Bledsoe,2018.0,132,381,249,0.3464566929133858
Eric Bledsoe,2019.0,141,449,308,0.31403118040089084
Eric Bledsoe,2020.0,82,247,165,0.3319838056680162
Eric Bledsoe,2021.0,121,355,234,0.3408450704225352
Eric Bledsoe,2022.0,51,163,112,0.3128834355828221
Eric Gordon,2009.0,131,337,206,0.3887240356083086
Eric Gordon,2010.0,119,321,202,0.3707165109034268
Eric Gordon,2011.0,106,291,185,0.3642611683848797
Eric Gordon,2012.0,10,40,30,0.25
Eric Gordon,2013.0,56,173,117,0.3236994219653179
Eric Gordon,2014.0,101,258,157,0.39147286821705424
Eric Gordon,2015.0,154,347,193,0.4438040345821326
Eric Gordon,2016.0,113,294,181,0.3843537414965986
Eric Gordon,2017.0,273,731,458,0.3734610123119015
Eric Gordon,2018.0,261,738,477,0.35365853658536583
Eric Gordon,2019.0,254,695,441,0.36546762589928056
Eric Gordon,2020.0,125,393,268,0.31806615776081426
Eric Gordon,2021.0,69,210,141,0.32857142857142857
Eric Gordon,2022.0,124,301,177,0.4119601328903654
Eric Gordon,2023.0,142,385,243,0.36883116883116884
Eric Gordon,2024.0,92,245,153,0.37551020408163266
Eric Maynor,2010.0,23,77,54,0.2987012987012987
Eric Maynor,2011.0,46,121,75,0.38016528925619836
Eric Maynor,2012.0,6,17,11,0.35294117647058826
Eric Maynor,2013.0,33,94,61,0.35106382978723405
Eric Maynor,2014.0,12,37,25,0.32432432432432434
Eric Moreland,2019.0,1,1,0,1.0
Eric Paschall,2020.0,37,129,92,0.2868217054263566
Eric Paschall,2021.0,18,54,36,0.3333333333333333
Eric Paschall,2022.0,41,110,69,0.37272727272727274
Eric Piatkowski,2004.0,43,122,79,0.3524590163934426
Eric Piatkowski,2005.0,62,147,85,0.4217687074829932
Eric Piatkowski,2006.0,11,38,27,0.2894736842105263
Eric Piatkowski,2007.0,7,18,11,0.3888888888888889
Eric Piatkowski,2008.0,11,26,15,0.4230769230769231
Eric Snow,2004.0,2,17,15,0.11764705882352941
Eric Snow,2005.0,13,45,32,0.28888888888888886
Eric Snow,2006.0,1,11,10,0.09090909090909091
Eric Snow,2007.0,0,7,7,0.0
Eric Snow,2008.0,0,2,2,0.0
Eric Williams,2004.0,34,126,92,0.2698412698412698
Eric Williams,2005.0,28,73,45,0.3835616438356164
Eric Williams,2006.0,5,18,13,0.2777777777777778
Eric Williams,2007.0,8,19,11,0.42105263157894735
Erick Dampier,2004.0,0,2,2,0.0
Erick Dampier,2005.0,0,4,4,0.0
Erick Dampier,2006.0,0,1,1,0.0
Erick Dampier,2010.0,1,3,2,0.3333333333333333
Erick Dampier,2011.0,0,1,1,0.0
Erick Green,2015.0,14,47,33,0.2978723404255319
Erick Green,2016.0,1,5,4,0.2
Erick Strickland,2004.0,29,71,42,0.4084507042253521
Erick Strickland,2005.0,21,83,62,0.25301204819277107
Erik Daniels,2005.0,1,2,1,0.5
Erik McCree,2018.0,0,1,1,0.0
Erik Murphy,2014.0,0,3,3,0.0
Ersan Ilyasova,2007.0,54,148,94,0.36486486486486486
Ersan Ilyasova,2010.0,86,255,169,0.33725490196078434
Ersan Ilyasova,2011.0,36,121,85,0.2975206611570248
Ersan Ilyasova,2012.0,51,112,61,0.45535714285714285
Ersan Ilyasova,2013.0,99,224,125,0.4419642857142857
Ersan Ilyasova,2014.0,37,131,94,0.2824427480916031
Ersan Ilyasova,2015.0,79,213,134,0.37089201877934275
Ersan Ilyasova,2016.0,96,259,163,0.37065637065637064
Ersan Ilyasova,2017.0,143,407,264,0.35135135135135137
Ersan Ilyasova,2018.0,100,284,184,0.352112676056338
Ersan Ilyasova,2019.0,70,200,130,0.35
Ersan Ilyasova,2020.0,51,142,91,0.3591549295774648
Ersan Ilyasova,2021.0,18,42,24,0.42857142857142855
Ervin Johnson,2004.0,0,1,1,0.0
Ervin Johnson,2005.0,1,1,0,1.0
Esteban Batista,2006.0,0,1,1,0.0
Eugene Jeter,2011.0,6,30,24,0.2
Eugene Omoruyi,2022.0,1,2,1,0.5
Eugene Omoruyi,2023.0,25,89,64,0.2808988764044944
Eugene Omoruyi,2024.0,5,17,12,0.29411764705882354
Evan Fournier,2013.0,22,62,40,0.3548387096774194
Evan Fournier,2014.0,89,237,148,0.3755274261603376
Evan Fournier,2015.0,85,225,140,0.37777777777777777
Evan Fournier,2016.0,156,390,234,0.4
Evan Fournier,2017.0,128,359,231,0.3565459610027855
Evan Fournier,2018.0,127,335,208,0.37910447761194027
Evan Fournier,2019.0,161,484,323,0.33264462809917356
Evan Fournier,2020.0,185,469,284,0.39445628997867804
Evan Fournier,2021.0,132,319,187,0.41379310344827586
Evan Fournier,2022.0,241,619,378,0.3893376413570275
Evan Fournier,2023.0,35,114,79,0.30701754385964913
Evan Fournier,2024.0,2,15,13,0.13333333333333333
Evan Mobley,2022.0,24,95,71,0.25263157894736843
Evan Mobley,2023.0,22,103,81,0.21359223300970873
Evan Mobley,2024.0,2,10,8,0.2
Evan Turner,2011.0,18,49,31,0.3673469387755102
Evan Turner,2012.0,11,55,44,0.2
Evan Turner,2013.0,58,159,101,0.36477987421383645
Evan Turner,2014.0,54,163,109,0.3312883435582822
Evan Turner,2015.0,35,123,88,0.2845528455284553
Evan Turner,2016.0,23,97,74,0.23711340206185566
Evan Turner,2017.0,36,132,96,0.2727272727272727
Evan Turner,2018.0,44,139,95,0.31654676258992803
Evan Turner,2019.0,12,54,42,0.2222222222222222
Evan Turner,2020.0,0,5,5,0.0
Fabricio Oberto,2006.0,0,2,2,0.0
Fabricio Oberto,2007.0,0,1,1,0.0
Fabricio Oberto,2008.0,0,1,1,0.0
Fabricio Oberto,2009.0,0,1,1,0.0
Facundo Campazzo,2021.0,95,264,169,0.35984848484848486
Facundo Campazzo,2022.0,58,195,137,0.29743589743589743
Facundo Campazzo,2023.0,3,11,8,0.2727272727272727
Filip Petrusev,2024.0,1,2,1,0.5
Francisco Elson,2004.0,0,1,1,0.0
Francisco Elson,2005.0,1,3,2,0.3333333333333333
Francisco Elson,2006.0,1,5,4,0.2
Francisco Elson,2007.0,0,3,3,0.0
Francisco Elson,2008.0,0,1,1,0.0
Francisco Elson,2009.0,1,4,3,0.25
Francisco Garcia,2006.0,40,141,101,0.28368794326241137
Francisco Garcia,2007.0,53,149,96,0.35570469798657717
Francisco Garcia,2008.0,113,289,176,0.39100346020761245
Francisco Garcia,2009.0,88,221,133,0.39819004524886875
Francisco Garcia,2010.0,23,59,36,0.3898305084745763
Francisco Garcia,2011.0,81,224,143,0.36160714285714285
Francisco Garcia,2012.0,38,131,93,0.2900763358778626
Francisco Garcia,2013.0,84,216,132,0.3888888888888889
Francisco Garcia,2014.0,69,196,127,0.3520408163265306
Francisco Garcia,2015.0,10,45,35,0.2222222222222222
Frank Jackson,2019.0,53,170,117,0.31176470588235294
Frank Jackson,2020.0,47,144,97,0.3263888888888889
Frank Jackson,2021.0,61,150,89,0.4066666666666667
Frank Jackson,2022.0,86,279,193,0.30824372759856633
Frank Jackson,2023.0,0,1,1,0.0
Frank Kaminsky,2016.0,73,219,146,0.3333333333333333
Frank Kaminsky,2017.0,116,354,238,0.327683615819209
Frank Kaminsky,2018.0,104,274,170,0.3795620437956204
Frank Kaminsky,2019.0,50,139,89,0.3597122302158273
Frank Kaminsky,2020.0,41,124,83,0.33064516129032256
Frank Kaminsky,2021.0,32,90,58,0.35555555555555557
Frank Kaminsky,2022.0,5,15,10,0.3333333333333333
Frank Kaminsky,2023.0,13,33,20,0.3939393939393939
Frank Mason,2018.0,31,86,55,0.36046511627906974
Frank Mason,2019.0,14,64,50,0.21875
Frank Mason,2020.0,6,21,15,0.2857142857142857
Frank Mason,2021.0,2,5,3,0.4
Frank Ntilikina,2018.0,50,157,107,0.3184713375796178
Frank Ntilikina,2019.0,33,115,82,0.28695652173913044
Frank Ntilikina,2020.0,44,137,93,0.32116788321167883
Frank Ntilikina,2021.0,23,49,26,0.46938775510204084
Frank Ntilikina,2022.0,44,130,86,0.3384615384615385
Frank Ntilikina,2023.0,17,67,50,0.2537313432835821
Frank Ntilikina,2024.0,1,4,3,0.25
Frank Williams,2004.0,22,73,51,0.3013698630136986
Frank Williams,2005.0,0,4,4,0.0
Franz Wagner,2022.0,96,270,174,0.35555555555555557
Franz Wagner,2023.0,130,360,230,0.3611111111111111
Franz Wagner,2024.0,57,187,130,0.3048128342245989
Fred Hoiberg,2004.0,98,220,122,0.44545454545454544
Fred Hoiberg,2005.0,70,145,75,0.4827586206896552
Fred Jones,2004.0,38,111,73,0.34234234234234234
Fred Jones,2005.0,96,252,156,0.38095238095238093
Fred Jones,2006.0,69,203,134,0.3399014778325123
Fred Jones,2007.0,39,128,89,0.3046875
Fred Jones,2008.0,72,188,116,0.3829787234042553
Fred Jones,2009.0,54,147,93,0.3673469387755102
Fred VanVleet,2017.0,13,34,21,0.38235294117647056
Fred VanVleet,2018.0,116,289,173,0.4013840830449827
Fred VanVleet,2019.0,150,394,244,0.38071065989847713
Fred VanVleet,2020.0,189,484,295,0.390495867768595
Fred VanVleet,2021.0,174,476,302,0.36554621848739494
Fred VanVleet,2022.0,254,678,424,0.3746312684365782
Fred VanVleet,2023.0,207,606,399,0.3415841584158416
Fred VanVleet,2024.0,129,341,212,0.3782991202346041
Freddie Gillespie,2022.0,0,1,1,0.0
Furkan Aldemir,2015.0,0,5,5,0.0
Furkan Korkmaz,2018.0,6,18,12,0.3333333333333333
Furkan Korkmaz,2019.0,50,152,102,0.32894736842105265
Furkan Korkmaz,2020.0,143,362,219,0.39502762430939226
Furkan Korkmaz,2021.0,115,313,198,0.36741214057507987
Furkan Korkmaz,2022.0,81,276,195,0.29347826086956524
Furkan Korkmaz,2023.0,18,47,29,0.3829787234042553
Furkan Korkmaz,2024.0,7,25,18,0.28
Gabe Pruitt,2008.0,3,12,9,0.25
Gabe Pruitt,2009.0,14,49,35,0.2857142857142857
Gabe Vincent,2020.0,6,27,21,0.2222222222222222
Gabe Vincent,2021.0,47,151,104,0.31125827814569534
Gabe Vincent,2022.0,144,404,260,0.3564356435643564
Gabe Vincent,2023.0,168,485,317,0.3463917525773196
Gabe Vincent,2024.0,2,17,15,0.11764705882352941
Gabe York ,2022.0,1,6,5,0.16666666666666666
Gabe York ,2023.0,6,18,12,0.3333333333333333
Gabriel Deck,2021.0,2,15,13,0.13333333333333333
Gabriel Deck,2022.0,2,4,2,0.5
Gabriel Lundberg ,2022.0,3,7,4,0.42857142857142855
Gal Mekel,2014.0,5,20,15,0.25
Gal Mekel,2015.0,0,3,3,0.0
Garrett Temple,2010.0,14,40,26,0.35
Garrett Temple,2011.0,10,37,27,0.2702702702702703
Garrett Temple,2013.0,26,80,54,0.325
Garrett Temple,2014.0,7,30,23,0.23333333333333334
Garrett Temple,2015.0,33,91,58,0.3626373626373626
Garrett Temple,2016.0,89,258,169,0.3449612403100775
Garrett Temple,2017.0,82,221,139,0.37104072398190047
Garrett Temple,2018.0,89,227,138,0.3920704845814978
Garrett Temple,2019.0,91,271,180,0.33579335793357934
Garrett Temple,2020.0,136,422,286,0.3222748815165877
Garrett Temple,2021.0,67,200,133,0.335
Garrett Temple,2022.0,59,184,125,0.32065217391304346
Garrett Temple,2023.0,11,26,15,0.4230769230769231
Garrett Temple,2024.0,2,6,4,0.3333333333333333
Garrison Mathews,2020.0,19,46,27,0.41304347826086957
Garrison Mathews,2021.0,78,207,129,0.37681159420289856
Garrison Mathews,2022.0,139,386,247,0.3601036269430052
Garrison Mathews,2023.0,63,180,117,0.35
Garrison Mathews,2024.0,36,79,43,0.45569620253164556
Gary Clark,2019.0,41,138,97,0.2971014492753623
Gary Clark,2020.0,50,143,93,0.34965034965034963
Gary Clark,2021.0,31,108,77,0.28703703703703703
Gary Clark,2022.0,28,69,41,0.4057971014492754
Gary Forbes,2011.0,19,58,39,0.3275862068965517
Gary Forbes,2012.0,29,83,54,0.3493975903614458
Gary Harris,2015.0,21,103,82,0.20388349514563106
Gary Harris,2016.0,105,297,192,0.35353535353535354
Gary Harris,2017.0,107,255,148,0.4196078431372549
Gary Harris,2018.0,156,394,238,0.39593908629441626
Gary Harris,2019.0,102,299,197,0.3411371237458194
Gary Harris,2020.0,89,262,173,0.33969465648854963
Gary Harris,2021.0,48,141,93,0.3404255319148936
Gary Harris,2022.0,116,302,186,0.3841059602649007
Gary Harris,2023.0,94,217,123,0.43317972350230416
Gary Harris,2024.0,36,108,72,0.3333333333333333
Gary Neal,2011.0,134,327,193,0.40978593272171254
Gary Neal,2012.0,99,234,135,0.4230769230769231
Gary Neal,2013.0,112,317,205,0.35331230283911674
Gary Neal,2014.0,72,198,126,0.36363636363636365
Gary Neal,2015.0,50,164,114,0.3048780487804878
Gary Neal,2016.0,41,100,59,0.41
Gary Neal,2017.0,0,2,2,0.0
Gary Payton,2004.0,68,217,149,0.31336405529953915
Gary Payton,2005.0,43,143,100,0.3006993006993007
Gary Payton,2006.0,83,288,205,0.2881944444444444
Gary Payton,2007.0,32,124,92,0.25806451612903225
Gary Payton II,2017.0,1,9,8,0.1111111111111111
Gary Payton II,2018.0,6,25,19,0.24
Gary Payton II,2019.0,1,2,1,0.5
Gary Payton II,2020.0,13,46,33,0.2826086956521739
Gary Payton II,2021.0,2,4,2,0.5
Gary Payton II,2022.0,51,135,84,0.37777777777777777
Gary Payton II,2023.0,17,41,24,0.4146341463414634
Gary Payton II,2024.0,9,32,23,0.28125
Gary Trent,2004.0,0,8,8,0.0
Gary Trent,2019.0,5,21,16,0.23809523809523808
Gary Trent,2020.0,123,295,172,0.41694915254237286
Gary Trent,2021.0,165,429,264,0.38461538461538464
Gary Trent,2022.0,222,584,362,0.3801369863013699
Gary Trent,2023.0,166,450,284,0.3688888888888889
Gary Trent,2024.0,97,232,135,0.41810344827586204
George Hill,2009.0,27,81,54,0.3333333333333333
George Hill,2010.0,86,217,131,0.39631336405529954
George Hill,2011.0,81,219,138,0.3698630136986301
George Hill,2012.0,69,187,118,0.3689839572192513
George Hill,2013.0,164,448,284,0.36607142857142855
George Hill,2014.0,123,337,214,0.3649851632047478
George Hill,2015.0,69,193,124,0.35751295336787564
George Hill,2016.0,141,341,200,0.41348973607038125
George Hill,2017.0,106,265,159,0.4
George Hill,2018.0,101,255,154,0.396078431372549
George Hill,2019.0,68,201,133,0.3383084577114428
George Hill,2020.0,91,204,113,0.44607843137254904
George Hill,2021.0,39,99,60,0.3939393939393939
George Hill,2022.0,42,136,94,0.3088235294117647
George Hill,2023.0,34,95,61,0.35789473684210527
George King,2022.0,0,4,4,0.0
George Lynch,2004.0,46,151,105,0.304635761589404
George Lynch,2005.0,11,37,26,0.2972972972972973
Georges Niang,2017.0,1,12,11,0.08333333333333333
Georges Niang,2018.0,0,4,4,0.0
Georges Niang,2019.0,47,118,71,0.3983050847457627
Georges Niang,2020.0,102,254,152,0.4015748031496063
Georges Niang,2021.0,133,322,189,0.41304347826086957
Georges Niang,2022.0,172,430,258,0.4
Georges Niang,2023.0,166,410,244,0.40487804878048783
Georges Niang,2024.0,78,212,134,0.36792452830188677
Georgios Kalaitzakis,2022.0,10,26,16,0.38461538461538464
Georgios Papagiannis,2017.0,0,2,2,0.0
Gerald Fitch,2006.0,7,26,19,0.2692307692307692
Gerald Green,2006.0,6,20,14,0.3
Gerald Green,2007.0,95,258,163,0.3682170542635659
Gerald Green,2008.0,15,39,24,0.38461538461538464
Gerald Green,2009.0,15,51,36,0.29411764705882354
Gerald Green,2012.0,43,110,67,0.39090909090909093
Gerald Green,2013.0,70,221,151,0.3167420814479638
Gerald Green,2014.0,204,510,306,0.4
Gerald Green,2015.0,137,387,250,0.35400516795865633
Gerald Green,2016.0,88,274,186,0.32116788321167883
Gerald Green,2017.0,60,156,96,0.38461538461538464
Gerald Green,2018.0,137,370,233,0.37027027027027026
Gerald Green,2019.0,166,470,304,0.35319148936170214
Gerald Henderson,2010.0,4,19,15,0.21052631578947367
Gerald Henderson,2011.0,7,36,29,0.19444444444444445
Gerald Henderson,2012.0,11,47,36,0.23404255319148937
Gerald Henderson,2013.0,33,100,67,0.33
Gerald Henderson,2014.0,40,124,84,0.3225806451612903
Gerald Henderson,2015.0,45,136,91,0.33088235294117646
Gerald Henderson,2016.0,55,155,100,0.3548387096774194
Gerald Henderson,2017.0,61,173,112,0.35260115606936415
Gerald Wallace,2004.0,0,2,2,0.0
Gerald Wallace,2005.0,17,62,45,0.27419354838709675
Gerald Wallace,2006.0,14,50,36,0.28
Gerald Wallace,2007.0,39,120,81,0.325
Gerald Wallace,2008.0,71,221,150,0.3212669683257919
Gerald Wallace,2009.0,39,131,92,0.29770992366412213
Gerald Wallace,2010.0,57,151,94,0.37748344370860926
Gerald Wallace,2011.0,65,203,138,0.32019704433497537
Gerald Wallace,2012.0,46,150,104,0.30666666666666664
Gerald Wallace,2013.0,57,192,135,0.296875
Gerald Wallace,2014.0,19,64,45,0.296875
Gerald Wallace,2015.0,1,3,2,0.3333333333333333
Gian Clavell,2018.0,6,15,9,0.4
Giannis Antetokounmpo,2014.0,41,118,77,0.3474576271186441
Giannis Antetokounmpo,2015.0,7,45,38,0.15555555555555556
Giannis Antetokounmpo,2016.0,28,109,81,0.25688073394495414
Giannis Antetokounmpo,2017.0,53,190,137,0.2789473684210526
Giannis Antetokounmpo,2018.0,47,154,107,0.3051948051948052
Giannis Antetokounmpo,2019.0,70,259,189,0.2702702702702703
Giannis Antetokounmpo,2020.0,102,333,231,0.3063063063063063
Giannis Antetokounmpo,2021.0,80,291,211,0.27491408934707906
Giannis Antetokounmpo,2022.0,80,283,203,0.2826855123674912
Giannis Antetokounmpo,2023.0,47,174,127,0.27011494252873564
Giannis Antetokounmpo,2024.0,19,76,57,0.25
Gigi Datome,2014.0,7,39,32,0.1794871794871795
Gigi Datome,2015.0,18,42,24,0.42857142857142855
Gilbert Arenas,2004.0,125,333,208,0.37537537537537535
Gilbert Arenas,2005.0,223,639,416,0.3489827856025039
Gilbert Arenas,2006.0,218,582,364,0.3745704467353952
Gilbert Arenas,2007.0,205,584,379,0.351027397260274
Gilbert Arenas,2008.0,27,90,63,0.3
Gilbert Arenas,2009.0,2,7,5,0.2857142857142857
Gilbert Arenas,2010.0,63,181,118,0.34806629834254144
Gilbert Arenas,2011.0,100,339,239,0.2949852507374631
Gilbert Arenas,2012.0,13,43,30,0.3023255813953488
Glen Davis,2008.0,0,1,1,0.0
Glen Davis,2009.0,2,5,3,0.4
Glen Davis,2010.0,0,7,7,0.0
Glen Davis,2011.0,2,16,14,0.125
Glen Davis,2012.0,2,14,12,0.14285714285714285
Glen Davis,2013.0,0,2,2,0.0
Glen Davis,2014.0,4,11,7,0.36363636363636365
Glen Davis,2015.0,0,5,5,0.0
Glen Rice,2004.0,5,28,23,0.17857142857142858
Glen Rice Jr.,2014.0,5,17,12,0.29411764705882354
Glen Rice Jr.,2015.0,1,7,6,0.14285714285714285
Glenn Robinson,2004.0,34,100,66,0.34
Glenn Robinson,2005.0,5,16,11,0.3125
Glenn Robinson III,2015.0,5,19,14,0.2631578947368421
Glenn Robinson III,2016.0,14,37,23,0.3783783783783784
Glenn Robinson III,2017.0,52,128,76,0.40625
Glenn Robinson III,2018.0,14,34,20,0.4117647058823529
Glenn Robinson III,2019.0,19,69,50,0.2753623188405797
Glenn Robinson III,2020.0,77,197,120,0.39086294416243655
Glenn Robinson III,2021.0,16,44,28,0.36363636363636365
Goga Bitadze,2020.0,8,42,34,0.19047619047619047
Goga Bitadze,2021.0,20,81,61,0.24691358024691357
Goga Bitadze,2022.0,23,80,57,0.2875
Goga Bitadze,2023.0,6,26,20,0.23076923076923078
Goga Bitadze,2024.0,2,10,8,0.2
Goran Dragic,2009.0,20,54,34,0.37037037037037035
Goran Dragic,2010.0,87,228,141,0.3815789473684211
Goran Dragic,2011.0,56,155,99,0.36129032258064514
Goran Dragic,2012.0,68,202,134,0.33663366336633666
Goran Dragic,2013.0,88,276,188,0.3188405797101449
Goran Dragic,2014.0,122,299,177,0.4080267558528428
Goran Dragic,2015.0,90,259,169,0.3474903474903475
Goran Dragic,2016.0,80,251,171,0.3187250996015936
Goran Dragic,2017.0,117,289,172,0.40484429065743943
Goran Dragic,2018.0,119,321,202,0.3707165109034268
Goran Dragic,2019.0,57,163,106,0.3496932515337423
Goran Dragic,2020.0,161,445,284,0.36179775280898874
Goran Dragic,2021.0,100,270,170,0.37037037037037035
Goran Dragic,2022.0,20,75,55,0.26666666666666666
Goran Dragic,2023.0,52,146,94,0.3561643835616438
Gordan Giricek,2004.0,60,152,92,0.39473684210526316
Gordan Giricek,2005.0,38,105,67,0.3619047619047619
Gordan Giricek,2006.0,18,59,41,0.3050847457627119
Gordan Giricek,2007.0,66,148,82,0.44594594594594594
Gordan Giricek,2008.0,37,103,66,0.3592233009708738
Gordon Hayward,2011.0,35,74,39,0.47297297297297297
Gordon Hayward,2012.0,56,171,115,0.32748538011695905
Gordon Hayward,2013.0,102,246,144,0.4146341463414634
Gordon Hayward,2014.0,85,280,195,0.30357142857142855
Gordon Hayward,2015.0,120,330,210,0.36363636363636365
Gordon Hayward,2016.0,143,410,267,0.348780487804878
Gordon Hayward,2017.0,177,442,265,0.4004524886877828
Gordon Hayward,2018.0,0,1,1,0.0
Gordon Hayward,2019.0,86,255,169,0.33725490196078434
Gordon Hayward,2020.0,92,246,154,0.37398373983739835
Gordon Hayward,2021.0,85,205,120,0.4146341463414634
Gordon Hayward,2022.0,86,220,134,0.39090909090909093
Gordon Hayward,2023.0,52,160,108,0.325
Gordon Hayward,2024.0,22,61,39,0.36065573770491804
Gorgui Dieng,2014.0,1,1,0,1.0
Gorgui Dieng,2015.0,1,6,5,0.16666666666666666
Gorgui Dieng,2016.0,6,20,14,0.3
Gorgui Dieng,2017.0,16,42,26,0.38095238095238093
Gorgui Dieng,2018.0,21,66,45,0.3181818181818182
Gorgui Dieng,2019.0,19,56,37,0.3392857142857143
Gorgui Dieng,2020.0,54,152,98,0.35526315789473684
Gorgui Dieng,2021.0,31,71,40,0.43661971830985913
Gorgui Dieng,2022.0,30,72,42,0.4166666666666667
Gorgui Dieng,2023.0,21,75,54,0.28
Gradey Dick,2024.0,20,58,38,0.3448275862068966
Grant Hill,2005.0,3,13,10,0.23076923076923078
Grant Hill,2006.0,2,8,6,0.25
Grant Hill,2007.0,2,12,10,0.16666666666666666
Grant Hill,2008.0,33,104,71,0.3173076923076923
Grant Hill,2009.0,24,76,52,0.3157894736842105
Grant Hill,2010.0,38,96,58,0.3958333333333333
Grant Hill,2011.0,45,114,69,0.39473684210526316
Grant Hill,2012.0,14,53,39,0.2641509433962264
Grant Hill,2013.0,3,11,8,0.2727272727272727
Grant Jerrett,2015.0,1,15,14,0.06666666666666667
Grant Riller,2021.0,2,4,2,0.5
Grant Williams,2020.0,34,113,79,0.3008849557522124
Grant Williams,2021.0,50,134,84,0.373134328358209
Grant Williams,2022.0,141,347,206,0.40634005763688763
Grant Williams,2023.0,133,331,198,0.40181268882175225
Grant Williams,2024.0,75,197,122,0.38071065989847713
Grayson Allen,2019.0,32,102,70,0.3137254901960784
Grayson Allen,2020.0,57,142,85,0.4014084507042254
Grayson Allen,2021.0,119,301,182,0.3953488372093023
Grayson Allen,2022.0,178,437,259,0.4073226544622426
Grayson Allen,2023.0,160,395,235,0.4050632911392405
Grayson Allen,2024.0,112,225,113,0.49777777777777776
Greg Brown,2022.0,19,61,42,0.3114754098360656
Greg Brown,2023.0,1,7,6,0.14285714285714285
Greg Brown,2024.0,1,3,2,0.3333333333333333
Greg Buckner,2004.0,12,44,32,0.2727272727272727
Greg Buckner,2005.0,51,130,79,0.3923076923076923
Greg Buckner,2006.0,96,275,179,0.3490909090909091
Greg Buckner,2007.0,32,107,75,0.29906542056074764
Greg Buckner,2008.0,15,50,35,0.3
Greg Buckner,2009.0,13,51,38,0.2549019607843137
Greg Monroe,2011.0,0,1,1,0.0
Greg Monroe,2012.0,0,1,1,0.0
Greg Monroe,2013.0,0,4,4,0.0
Greg Monroe,2014.0,0,1,1,0.0
Greg Monroe,2016.0,0,1,1,0.0
Greg Monroe,2017.0,0,5,5,0.0
Greg Monroe,2019.0,2,9,7,0.2222222222222222
Greg Ostertag,2004.0,0,1,1,0.0
Greg Ostertag,2005.0,0,2,2,0.0
Greg Smith,2013.0,0,1,1,0.0
Greg Stiemsma,2014.0,0,1,1,0.0
Greg Whittington,2021.0,0,2,2,0.0
Gregory Jackson,2024.0,23,49,26,0.46938775510204084
Greivis Vasquez,2011.0,29,97,68,0.29896907216494845
Greivis Vasquez,2012.0,43,135,92,0.31851851851851853
Greivis Vasquez,2013.0,83,243,160,0.34156378600823045
Greivis Vasquez,2014.0,119,316,197,0.37658227848101267
Greivis Vasquez,2015.0,138,365,227,0.3780821917808219
Greivis Vasquez,2016.0,18,73,55,0.2465753424657534
Greivis Vasquez,2017.0,1,3,2,0.3333333333333333
Guerschon Yabusele,2018.0,12,43,31,0.27906976744186046
Guerschon Yabusele,2019.0,9,29,20,0.3103448275862069
Gui Santos,2024.0,1,7,6,0.14285714285714285
Guillermo Diaz,2008.0,0,1,1,0.0
Gustavo Ayon,2012.0,0,1,1,0.0
Hakim Warrick,2006.0,0,1,1,0.0
Hakim Warrick,2007.0,0,8,8,0.0
Hakim Warrick,2008.0,13,48,35,0.2708333333333333
Hakim Warrick,2009.0,5,23,18,0.21739130434782608
Hakim Warrick,2010.0,1,8,7,0.125
Hakim Warrick,2011.0,1,11,10,0.09090909090909091
Hakim Warrick,2012.0,1,10,9,0.1
Hakim Warrick,2013.0,0,3,3,0.0
Hamed Haddadi,2010.0,0,3,3,0.0
Hamed Haddadi,2011.0,0,2,2,0.0
Hamed Haddadi,2012.0,0,1,1,0.0
Hamidou Diallo,2019.0,4,24,20,0.16666666666666666
Hamidou Diallo,2020.0,17,62,45,0.27419354838709675
Hamidou Diallo,2021.0,28,82,54,0.34146341463414637
Hamidou Diallo,2022.0,23,93,70,0.24731182795698925
Hamidou Diallo,2023.0,5,21,16,0.23809523809523808
Harrison Barnes,2013.0,71,197,126,0.3604060913705584
Harrison Barnes,2014.0,74,211,137,0.35071090047393366
Harrison Barnes,2015.0,109,277,168,0.3935018050541516
Harrison Barnes,2016.0,108,290,182,0.3724137931034483
Harrison Barnes,2017.0,78,222,144,0.35135135135135137
Harrison Barnes,2018.0,119,333,214,0.35735735735735735
Harrison Barnes,2019.0,174,441,267,0.3945578231292517
Harrison Barnes,2020.0,102,268,166,0.3805970149253731
Harrison Barnes,2021.0,100,256,156,0.390625
Harrison Barnes,2022.0,142,360,218,0.39444444444444443
Harrison Barnes,2023.0,138,378,240,0.36507936507936506
Harrison Barnes,2024.0,84,202,118,0.4158415841584158
Harry Giles,2019.0,0,6,6,0.0
Harry Giles,2020.0,0,2,2,0.0
Harry Giles,2021.0,8,23,15,0.34782608695652173
Harry Giles,2024.0,1,8,7,0.125
Hassan Adams,2007.0,0,1,1,0.0
Hassan Whiteside,2018.0,2,2,0,1.0
Hassan Whiteside,2019.0,2,16,14,0.125
Hassan Whiteside,2020.0,5,8,3,0.625
Hassan Whiteside,2021.0,0,1,1,0.0
Hassani Gravett,2022.0,11,26,15,0.4230769230769231
Haywood Highsmith,2019.0,1,5,4,0.2
Haywood Highsmith,2022.0,12,33,21,0.36363636363636365
Haywood Highsmith,2023.0,45,125,80,0.36
Haywood Highsmith,2024.0,39,97,58,0.4020618556701031
Hedo Turkoglu,2004.0,115,283,168,0.40636042402826855
Hedo Turkoglu,2005.0,93,245,152,0.3795918367346939
Hedo Turkoglu,2006.0,114,283,169,0.4028268551236749
Hedo Turkoglu,2007.0,112,290,178,0.38620689655172413
Hedo Turkoglu,2008.0,176,450,274,0.39111111111111113
Hedo Turkoglu,2009.0,166,459,293,0.3616557734204793
Hedo Turkoglu,2010.0,108,289,181,0.3737024221453287
Hedo Turkoglu,2011.0,134,340,206,0.3941176470588235
Hedo Turkoglu,2012.0,96,270,174,0.35555555555555557
Hedo Turkoglu,2013.0,1,24,23,0.041666666666666664
Hedo Turkoglu,2014.0,26,60,34,0.43333333333333335
Hedo Turkoglu,2015.0,62,152,90,0.40789473684210525
Henry Ellenson,2017.0,10,34,24,0.29411764705882354
Henry Ellenson,2018.0,20,60,40,0.3333333333333333
Henry Ellenson,2019.0,17,38,21,0.4473684210526316
Henry Ellenson,2020.0,0,4,4,0.0
Henry Ellenson,2021.0,2,9,7,0.2222222222222222
Henry Sims,2014.0,0,1,1,0.0
Henry Sims,2015.0,4,22,18,0.18181818181818182
Henry Walker,2009.0,0,1,1,0.0
Henry Walker,2010.0,50,116,66,0.43103448275862066
Henry Walker,2011.0,62,164,102,0.3780487804878049
Henry Walker,2012.0,36,113,77,0.3185840707964602
Henry Walker,2015.0,45,132,87,0.3409090909090909
Herbert Jones,2022.0,65,188,123,0.34574468085106386
Herbert Jones,2023.0,56,167,111,0.33532934131736525
Herbert Jones,2024.0,58,150,92,0.38666666666666666
Hilton Armstrong,2009.0,0,2,2,0.0
Hilton Armstrong,2010.0,0,1,1,0.0
Hilton Armstrong,2011.0,2,4,2,0.5
Hilton Armstrong,2014.0,0,1,1,0.0
Hollis Thompson,2014.0,67,167,100,0.40119760479041916
Hollis Thompson,2015.0,115,287,172,0.40069686411149824
Hollis Thompson,2016.0,149,392,243,0.38010204081632654
Hollis Thompson,2017.0,32,95,63,0.3368421052631579
Horace Grant,2004.0,0,1,1,0.0
Horace Jenkins,2005.0,0,9,9,0.0
Howard Eisley,2004.0,52,163,111,0.31901840490797545
Howard Eisley,2005.0,27,103,76,0.2621359223300971
Howard Eisley,2006.0,13,42,29,0.30952380952380953
Hubert Davis,2004.0,0,1,1,0.0
Hunter Tyson,2024.0,0,4,4,0.0
Ian Clark,2014.0,11,31,20,0.3548387096774194
Ian Clark,2015.0,10,30,20,0.3333333333333333
Ian Clark,2016.0,36,102,66,0.35294117647058826
Ian Clark,2017.0,74,199,125,0.37185929648241206
Ian Clark,2018.0,72,223,151,0.32286995515695066
Ian Clark,2019.0,66,202,136,0.32673267326732675
Ian Mahinmi,2011.0,0,2,2,0.0
Ian Mahinmi,2012.0,0,1,1,0.0
Ian Mahinmi,2013.0,0,2,2,0.0
Ian Mahinmi,2014.0,0,1,1,0.0
Ian Mahinmi,2018.0,0,2,2,0.0
Ian Mahinmi,2019.0,3,16,13,0.1875
Ian Mahinmi,2020.0,5,26,21,0.19230769230769232
Ignas Brazdeikis,2020.0,1,9,8,0.1111111111111111
Ignas Brazdeikis,2021.0,11,28,17,0.39285714285714285
Ignas Brazdeikis,2022.0,27,87,60,0.3103448275862069
Ike Diogu,2009.0,1,2,1,0.5
Iman Shumpert,2012.0,48,158,110,0.3037974683544304
Iman Shumpert,2013.0,69,169,100,0.40828402366863903
Iman Shumpert,2014.0,76,228,152,0.3333333333333333
Iman Shumpert,2015.0,100,289,189,0.3460207612456747
Iman Shumpert,2016.0,56,180,124,0.3111111111111111
Iman Shumpert,2017.0,104,288,184,0.3611111111111111
Iman Shumpert,2018.0,7,26,19,0.2692307692307692
Iman Shumpert,2019.0,103,295,192,0.34915254237288135
Iman Shumpert,2020.0,8,33,25,0.24242424242424243
Iman Shumpert,2021.0,0,3,3,0.0
Ime Udoka,2004.0,0,1,1,0.0
Ime Udoka,2006.0,1,3,2,0.3333333333333333
Ime Udoka,2007.0,89,219,130,0.4063926940639269
Ime Udoka,2008.0,77,205,128,0.375609756097561
Ime Udoka,2009.0,42,133,91,0.3157894736842105
Ime Udoka,2010.0,26,91,65,0.2857142857142857
Ime Udoka,2011.0,0,8,8,0.0
Immanuel Quickley,2021.0,122,314,192,0.3885350318471338
Immanuel Quickley,2022.0,137,396,259,0.34595959595959597
Immanuel Quickley,2023.0,177,491,314,0.3604887983706721
Immanuel Quickley,2024.0,96,234,138,0.41025641025641024
Ira Newble,2004.0,2,19,17,0.10526315789473684
Ira Newble,2005.0,19,53,34,0.3584905660377358
Ira Newble,2006.0,4,14,10,0.2857142857142857
Ira Newble,2007.0,8,17,9,0.47058823529411764
Ira Newble,2008.0,16,49,33,0.32653061224489793
Isaac Bonga,2019.0,0,8,8,0.0
Isaac Bonga,2020.0,25,71,46,0.352112676056338
Isaac Bonga,2021.0,14,51,37,0.27450980392156865
Isaac Bonga,2022.0,1,4,3,0.25
Isaac Humphries,2019.0,3,11,8,0.2727272727272727
Isaac Okoro,2021.0,62,214,152,0.2897196261682243
Isaac Okoro,2022.0,55,158,103,0.34810126582278483
Isaac Okoro,2023.0,66,184,118,0.358695652173913
Isaac Okoro,2024.0,30,84,54,0.35714285714285715
Isaiah Briscoe,2019.0,11,34,23,0.3235294117647059
Isaiah Canaan,2014.0,18,55,37,0.32727272727272727
Isaiah Canaan,2015.0,91,246,155,0.3699186991869919
Isaiah Canaan,2016.0,176,485,309,0.3628865979381443
Isaiah Canaan,2017.0,30,108,78,0.2777777777777778
Isaiah Canaan,2018.0,22,66,44,0.3333333333333333
Isaiah Canaan,2019.0,34,96,62,0.3541666666666667
Isaiah Hartenstein,2019.0,2,6,4,0.3333333333333333
Isaiah Hartenstein,2020.0,0,5,5,0.0
Isaiah Hartenstein,2021.0,2,6,4,0.3333333333333333
Isaiah Hartenstein,2022.0,14,30,16,0.4666666666666667
Isaiah Hartenstein,2023.0,8,37,29,0.21621621621621623
Isaiah Hartenstein,2024.0,1,3,2,0.3333333333333333
Isaiah Hicks,2018.0,2,9,7,0.2222222222222222
Isaiah Jackson,2022.0,5,16,11,0.3125
Isaiah Jackson,2023.0,2,14,12,0.14285714285714285
Isaiah Jackson,2024.0,0,3,3,0.0
Isaiah Joe,2021.0,39,108,69,0.3611111111111111
Isaiah Joe,2022.0,46,138,92,0.3333333333333333
Isaiah Joe,2023.0,161,394,233,0.4086294416243655
Isaiah Joe,2024.0,94,223,129,0.42152466367713004
Isaiah Livers,2022.0,27,64,37,0.421875
Isaiah Livers,2023.0,74,203,129,0.3645320197044335
Isaiah Livers,2024.0,22,77,55,0.2857142857142857
Isaiah Mobley,2023.0,3,8,5,0.375
Isaiah Mobley,2024.0,1,2,1,0.5
Isaiah Roby,2021.0,32,109,77,0.29357798165137616
Isaiah Roby,2022.0,44,99,55,0.4444444444444444
Isaiah Roby,2023.0,18,60,42,0.3
Isaiah Stewart,2021.0,21,63,42,0.3333333333333333
Isaiah Stewart,2022.0,15,46,31,0.32608695652173914
Isaiah Stewart,2023.0,67,205,138,0.32682926829268294
Isaiah Stewart,2024.0,49,131,82,0.37404580152671757
Isaiah Taylor,2017.0,0,3,3,0.0
Isaiah Taylor,2018.0,20,80,60,0.25
Isaiah Thomas,2012.0,83,219,136,0.3789954337899543
Isaiah Thomas,2013.0,115,321,206,0.3582554517133956
Isaiah Thomas,2014.0,127,364,237,0.3489010989010989
Isaiah Thomas,2015.0,132,364,232,0.3626373626373626
Isaiah Thomas,2016.0,180,511,331,0.3522504892367906
Isaiah Thomas,2017.0,281,753,472,0.37317397078353254
Isaiah Thomas,2018.0,55,188,133,0.2925531914893617
Isaiah Thomas,2019.0,12,43,31,0.27906976744186046
Isaiah Thomas,2020.0,78,189,111,0.4126984126984127
Isaiah Thomas,2021.0,3,12,9,0.25
Isaiah Thomas,2022.0,29,84,55,0.34523809523809523
Isaiah Todd,2022.0,4,16,12,0.25
Isaiah Todd,2023.0,1,10,9,0.1
Isaiah Whitehead,2017.0,42,144,102,0.2916666666666667
Isaiah Whitehead,2018.0,7,18,11,0.3888888888888889
Isaiah Wong,2024.0,1,1,0,1.0
Ish Smith,2011.0,3,10,7,0.3
Ish Smith,2012.0,3,9,6,0.3333333333333333
Ish Smith,2013.0,8,27,19,0.2962962962962963
Ish Smith,2014.0,1,23,22,0.043478260869565216
Ish Smith,2015.0,18,60,42,0.3
Ish Smith,2016.0,56,170,114,0.32941176470588235
Ish Smith,2017.0,28,105,77,0.26666666666666666
Ish Smith,2018.0,35,101,66,0.3465346534653465
Ish Smith,2019.0,45,142,97,0.31690140845070425
Ish Smith,2020.0,62,169,107,0.3668639053254438
Ish Smith,2021.0,21,57,36,0.3684210526315789
Ish Smith,2022.0,25,67,42,0.373134328358209
Ish Smith,2023.0,2,12,10,0.16666666666666666
Ish Smith,2024.0,2,6,4,0.3333333333333333
Ishmail Wainright,2022.0,22,65,43,0.3384615384615385
Ishmail Wainright,2023.0,58,177,119,0.327683615819209
Ishmail Wainright,2024.0,6,16,10,0.375
Ivan Johnson,2012.0,2,7,5,0.2857142857142857
Ivan Johnson,2013.0,1,13,12,0.07692307692307693
Ivan McFarlin,2007.0,0,1,1,0.0
Ivan Rabb,2019.0,3,15,12,0.2
Ivica Zubac,2017.0,0,3,3,0.0
Ivica Zubac,2018.0,0,1,1,0.0
Ivica Zubac,2020.0,0,2,2,0.0
Ivica Zubac,2021.0,1,4,3,0.25
Ivica Zubac,2023.0,0,2,2,0.0
J.J. Barea,2007.0,6,21,15,0.2857142857142857
J.J. Barea,2008.0,23,56,33,0.4107142857142857
J.J. Barea,2009.0,60,170,110,0.35294117647058826
J.J. Barea,2010.0,60,167,107,0.3592814371257485
J.J. Barea,2011.0,82,239,157,0.34309623430962344
J.J. Barea,2012.0,53,143,90,0.3706293706293706
J.J. Barea,2013.0,97,280,183,0.3464285714285714
J.J. Barea,2014.0,73,231,158,0.31601731601731603
J.J. Barea,2015.0,58,183,125,0.31693989071038253
J.J. Barea,2016.0,101,268,167,0.376865671641791
J.J. Barea,2017.0,53,148,95,0.3581081081081081
J.J. Barea,2018.0,115,313,198,0.36741214057507987
J.J. Barea,2019.0,38,128,90,0.296875
J.J. Barea,2020.0,32,85,53,0.3764705882352941
J.J. Hickson,2010.0,0,1,1,0.0
J.J. Hickson,2011.0,0,5,5,0.0
J.J. Hickson,2012.0,0,2,2,0.0
J.J. Hickson,2013.0,0,2,2,0.0
J.J. Hickson,2014.0,0,8,8,0.0
J.J. Hickson,2015.0,0,2,2,0.0
J.J. Hickson,2016.0,0,1,1,0.0
J.J. Redick,2007.0,39,99,60,0.3939393939393939
J.J. Redick,2008.0,17,46,29,0.3695652173913043
J.J. Redick,2009.0,88,231,143,0.38095238095238093
J.J. Redick,2010.0,126,309,183,0.4077669902912621
J.J. Redick,2011.0,88,234,146,0.37606837606837606
J.J. Redick,2012.0,116,287,171,0.40418118466898956
J.J. Redick,2013.0,169,463,294,0.3650107991360691
J.J. Redick,2014.0,99,250,151,0.396
J.J. Redick,2015.0,235,546,311,0.43040293040293043
J.J. Redick,2016.0,211,452,241,0.4668141592920354
J.J. Redick,2017.0,210,494,284,0.4251012145748988
J.J. Redick,2018.0,219,535,316,0.4093457943925234
J.J. Redick,2019.0,276,692,416,0.3988439306358382
J.J. Redick,2020.0,180,397,217,0.4534005037783375
J.J. Redick,2021.0,66,178,112,0.3707865168539326
J.P. Macura,2019.0,0,4,4,0.0
J.R. Bremer,2004.0,19,74,55,0.25675675675675674
J.R. Giddens,2010.0,0,10,10,0.0
J.R. Smith,2005.0,81,281,200,0.28825622775800713
J.R. Smith,2006.0,52,140,88,0.37142857142857144
J.R. Smith,2007.0,149,394,245,0.37817258883248733
J.R. Smith,2008.0,164,412,248,0.39805825242718446
J.R. Smith,2009.0,218,559,341,0.38998211091234347
J.R. Smith,2010.0,169,498,329,0.3393574297188755
J.R. Smith,2011.0,133,339,206,0.39233038348082594
J.R. Smith,2012.0,72,221,149,0.3257918552036199
J.R. Smith,2013.0,173,502,329,0.34462151394422313
J.R. Smith,2014.0,189,480,291,0.39375
J.R. Smith,2015.0,214,568,354,0.3767605633802817
J.R. Smith,2016.0,269,661,392,0.4069591527987897
J.R. Smith,2017.0,135,351,216,0.38461538461538464
J.R. Smith,2018.0,187,502,315,0.37250996015936255
J.R. Smith,2019.0,12,39,27,0.3076923076923077
J.R. Smith,2020.0,7,33,26,0.21212121212121213
JD Davison,2023.0,2,7,5,0.2857142857142857
JD Davison,2024.0,0,1,1,0.0
JT Thor,2022.0,7,27,20,0.25925925925925924
JT Thor,2023.0,39,123,84,0.3170731707317073
JT Thor,2024.0,19,58,39,0.3275862068965517
Ja Morant,2020.0,63,185,122,0.34054054054054056
Ja Morant,2021.0,90,287,197,0.313588850174216
Ja Morant,2022.0,105,306,201,0.3431372549019608
Ja Morant,2023.0,105,331,226,0.31722054380664655
Ja Morant,2024.0,14,51,37,0.27450980392156865
JaKarr Sampson,2015.0,31,127,96,0.2440944881889764
JaKarr Sampson,2016.0,14,63,49,0.2222222222222222
JaKarr Sampson,2018.0,5,10,5,0.5
JaKarr Sampson,2019.0,5,14,9,0.35714285714285715
JaKarr Sampson,2020.0,2,13,11,0.15384615384615385
JaKarr Sampson,2021.0,3,15,12,0.2
JaMychal Green,2015.0,0,7,7,0.0
JaMychal Green,2016.0,15,46,31,0.32608695652173914
JaMychal Green,2017.0,61,158,97,0.3860759493670886
JaMychal Green,2018.0,43,127,84,0.33858267716535434
JaMychal Green,2019.0,83,199,116,0.41708542713567837
JaMychal Green,2020.0,102,261,159,0.39080459770114945
JaMychal Green,2021.0,85,218,133,0.38990825688073394
JaMychal Green,2022.0,34,129,95,0.26356589147286824
JaMychal Green,2023.0,47,129,82,0.3643410852713178
JaQuori McLaughlin,2022.0,0,1,1,0.0
JaVale McGee,2010.0,0,1,1,0.0
JaVale McGee,2011.0,0,3,3,0.0
JaVale McGee,2013.0,1,1,0,1.0
JaVale McGee,2016.0,0,1,1,0.0
JaVale McGee,2017.0,0,4,4,0.0
JaVale McGee,2018.0,0,7,7,0.0
JaVale McGee,2019.0,1,12,11,0.08333333333333333
JaVale McGee,2020.0,3,8,5,0.375
JaVale McGee,2021.0,5,26,21,0.19230769230769232
JaVale McGee,2022.0,2,10,8,0.2
JaVale McGee,2023.0,2,5,3,0.4
JaVale McGee,2024.0,0,3,3,0.0
Jabari Bird,2018.0,3,7,4,0.42857142857142855
Jabari Brown,2015.0,23,62,39,0.3709677419354839
Jabari Parker,2015.0,4,16,12,0.25
Jabari Parker,2016.0,9,35,26,0.2571428571428571
Jabari Parker,2017.0,65,178,113,0.3651685393258427
Jabari Parker,2018.0,37,100,63,0.37
Jabari Parker,2019.0,61,195,134,0.3128205128205128
Jabari Parker,2020.0,32,119,87,0.2689075630252101
Jabari Parker,2021.0,4,16,12,0.25
Jabari Parker,2022.0,8,16,8,0.5
Jabari Smith,2004.0,0,3,3,0.0
Jabari Smith,2005.0,1,2,1,0.5
Jabari Smith Jr.,2023.0,120,391,271,0.3069053708439898
Jabari Smith Jr.,2024.0,68,178,110,0.38202247191011235
Jabari Walker,2023.0,16,56,40,0.2857142857142857
Jabari Walker,2024.0,24,84,60,0.2857142857142857
Jack White,2023.0,3,9,6,0.3333333333333333
Jackson Vroman,2005.0,0,3,3,0.0
Jacob Evans,2019.0,5,17,12,0.29411764705882354
Jacob Evans,2020.0,13,39,26,0.3333333333333333
Jacob Gilyard,2024.0,31,78,47,0.3974358974358974
Jacob Pullen,2018.0,0,1,1,0.0
Jacob Toppin,2024.0,7,14,7,0.5
Jacob Wiley,2018.0,1,2,1,0.5
Jacque Vaughn,2004.0,3,20,17,0.15
Jacque Vaughn,2005.0,5,15,10,0.3333333333333333
Jacque Vaughn,2006.0,1,7,6,0.14285714285714285
Jacque Vaughn,2007.0,1,2,1,0.5
Jacque Vaughn,2008.0,3,11,8,0.2727272727272727
Jacque Vaughn,2009.0,1,1,0,1.0
Jaden Hardy,2023.0,63,156,93,0.40384615384615385
Jaden Hardy,2024.0,54,156,102,0.34615384615384615
Jaden Ivey,2023.0,120,350,230,0.34285714285714286
Jaden Ivey,2024.0,56,171,115,0.32748538011695905
Jaden McDaniels,2021.0,72,198,126,0.36363636363636365
Jaden McDaniels,2022.0,90,272,182,0.33088235294117646
Jaden McDaniels,2023.0,107,270,163,0.3962962962962963
Jaden McDaniels,2024.0,45,118,73,0.3813559322033898
Jaden Springer,2022.0,0,1,1,0.0
Jaden Springer,2023.0,2,5,3,0.4
Jaden Springer,2024.0,5,25,20,0.2
Jae Crowder,2013.0,63,192,129,0.328125
Jae Crowder,2014.0,53,158,105,0.33544303797468356
Jae Crowder,2015.0,64,218,154,0.29357798165137616
Jae Crowder,2016.0,132,404,272,0.32673267326732675
Jae Crowder,2017.0,188,484,296,0.3884297520661157
Jae Crowder,2018.0,132,407,275,0.32432432432432434
Jae Crowder,2019.0,182,552,370,0.32971014492753625
Jae Crowder,2020.0,190,555,365,0.34234234234234234
Jae Crowder,2021.0,202,522,320,0.38697318007662834
Jae Crowder,2022.0,146,428,282,0.3411214953271028
Jae Crowder,2023.0,24,61,37,0.39344262295081966
Jae Crowder,2024.0,25,57,32,0.43859649122807015
Jae'Sean Tate,2021.0,60,195,135,0.3076923076923077
Jae'Sean Tate,2022.0,63,202,139,0.3118811881188119
Jae'Sean Tate,2023.0,13,46,33,0.2826086956521739
Jae'Sean Tate,2024.0,18,63,45,0.2857142857142857
Jahlil Okafor,2016.0,1,6,5,0.16666666666666666
Jahlil Okafor,2018.0,1,4,3,0.25
Jahlil Okafor,2019.0,1,5,4,0.2
Jahlil Okafor,2020.0,1,3,2,0.3333333333333333
Jahlil Okafor,2021.0,2,9,7,0.2222222222222222
Jahmi'us Ramsey,2021.0,5,19,14,0.2631578947368421
Jahmi'us Ramsey,2022.0,5,18,13,0.2777777777777778
Jaime Jaquez,2024.0,35,91,56,0.38461538461538464
Jake LaRavia,2023.0,24,71,47,0.3380281690140845
Jake LaRavia,2024.0,5,24,19,0.20833333333333334
Jake Layman,2017.0,14,52,38,0.2692307692307692
Jake Layman,2018.0,4,20,16,0.2
Jake Layman,2019.0,59,186,127,0.3172043010752688
Jake Layman,2020.0,24,72,48,0.3333333333333333
Jake Layman,2021.0,23,78,55,0.2948717948717949
Jake Layman,2022.0,8,35,27,0.22857142857142856
Jake Voskuhl,2006.0,1,3,2,0.3333333333333333
Jakob Poeltl,2018.0,1,3,2,0.3333333333333333
Jakob Poeltl,2019.0,0,1,1,0.0
Jakob Poeltl,2022.0,1,1,0,1.0
Jakob Poeltl,2023.0,0,1,1,0.0
Jalen Brunson,2019.0,63,181,118,0.34806629834254144
Jalen Brunson,2020.0,43,120,77,0.35833333333333334
Jalen Brunson,2021.0,87,213,126,0.4084507042253521
Jalen Brunson,2022.0,120,327,207,0.3669724770642202
Jalen Brunson,2023.0,160,402,242,0.39800995024875624
Jalen Brunson,2024.0,124,291,167,0.4261168384879725
Jalen Duren,2023.0,0,2,2,0.0
Jalen Duren,2024.0,0,2,2,0.0
Jalen Green,2022.0,157,458,301,0.34279475982532753
Jalen Green,2023.0,187,554,367,0.33754512635379064
Jalen Green,2024.0,93,292,199,0.3184931506849315
Jalen Harris,2021.0,17,36,19,0.4722222222222222
Jalen Hood-Schifino,2024.0,1,9,8,0.1111111111111111
Jalen Johnson,2021.0,1,13,12,0.07692307692307693
Jalen Johnson,2022.0,4,15,11,0.26666666666666666
Jalen Johnson,2023.0,34,115,81,0.2956521739130435
Jalen Johnson,2024.0,38,103,65,0.36893203883495146
Jalen Jones,2018.0,10,26,16,0.38461538461538464
Jalen Jones,2019.0,10,28,18,0.35714285714285715
Jalen Lecque,2020.0,0,4,4,0.0
Jalen Lecque,2021.0,0,1,1,0.0
Jalen McDaniels,2020.0,9,24,15,0.375
Jalen McDaniels,2021.0,35,105,70,0.3333333333333333
Jalen McDaniels,2022.0,43,112,69,0.38392857142857145
Jalen McDaniels,2023.0,80,241,161,0.33195020746887965
Jalen McDaniels,2024.0,8,45,37,0.17777777777777778
Jalen Pickett,2024.0,5,19,14,0.2631578947368421
Jalen Rose,2004.0,69,202,133,0.3415841584158416
Jalen Rose,2005.0,108,274,166,0.39416058394160586
Jalen Rose,2006.0,59,172,113,0.3430232558139535
Jalen Rose,2007.0,21,48,27,0.4375
Jalen Slawson,2024.0,5,24,19,0.20833333333333334
Jalen Smith,2021.0,5,18,13,0.2777777777777778
Jalen Smith,2022.0,40,122,82,0.32786885245901637
Jalen Smith,2023.0,54,191,137,0.28272251308900526
Jalen Smith,2024.0,38,78,40,0.48717948717948717
Jalen Suggs,2022.0,42,196,154,0.21428571428571427
Jalen Suggs,2023.0,66,202,136,0.32673267326732675
Jalen Suggs,2024.0,83,217,134,0.3824884792626728
Jalen Williams,2023.0,73,205,132,0.35609756097560974
Jalen Williams,2024.0,59,133,74,0.44360902255639095
Jalen Wilson,2023.0,0,1,1,0.0
Jalen Wilson,2024.0,2,8,6,0.25
Jamaal Franklin,2014.0,5,11,6,0.45454545454545453
Jamaal Franklin,2015.0,1,2,1,0.5
Jamaal Magloire,2004.0,0,2,2,0.0
Jamaal Tinsley,2004.0,93,261,168,0.3563218390804598
Jamaal Tinsley,2005.0,60,174,114,0.3448275862068966
Jamaal Tinsley,2006.0,16,72,56,0.2222222222222222
Jamaal Tinsley,2007.0,61,193,132,0.3160621761658031
Jamaal Tinsley,2008.0,40,141,101,0.28368794326241137
Jamaal Tinsley,2010.0,7,39,32,0.1794871794871795
Jamaal Tinsley,2012.0,11,41,30,0.2682926829268293
Jamaal Tinsley,2013.0,39,127,88,0.30708661417322836
Jamaal Tinsley,2014.0,1,15,14,0.06666666666666667
Jamal Cain,2023.0,7,20,13,0.35
Jamal Cain,2024.0,8,25,17,0.32
Jamal Crawford,2004.0,165,521,356,0.31669865642994244
Jamal Crawford,2005.0,185,512,327,0.361328125
Jamal Crawford,2006.0,101,293,192,0.3447098976109215
Jamal Crawford,2007.0,103,322,219,0.3198757763975155
Jamal Crawford,2008.0,173,488,315,0.35450819672131145
Jamal Crawford,2009.0,142,394,252,0.3604060913705584
Jamal Crawford,2010.0,181,477,296,0.37945492662473795
Jamal Crawford,2011.0,140,409,269,0.3422982885085575
Jamal Crawford,2012.0,80,260,180,0.3076923076923077
Jamal Crawford,2013.0,155,418,263,0.3708133971291866
Jamal Crawford,2014.0,188,525,337,0.3580952380952381
Jamal Crawford,2015.0,137,438,301,0.3127853881278539
Jamal Crawford,2016.0,121,365,244,0.3315068493150685
Jamal Crawford,2017.0,122,347,225,0.3515850144092219
Jamal Crawford,2018.0,111,331,220,0.33534743202416917
Jamal Crawford,2019.0,67,202,135,0.3316831683168317
Jamal Crawford,2020.0,1,2,1,0.5
Jamal Mashburn,2004.0,19,67,48,0.2835820895522388
Jamal Murray,2017.0,115,343,228,0.33527696793002915
Jamal Murray,2018.0,165,436,271,0.37844036697247707
Jamal Murray,2019.0,180,497,317,0.36217303822937624
Jamal Murray,2020.0,174,461,287,0.3774403470715835
Jamal Murray,2021.0,129,316,187,0.40822784810126583
Jamal Murray,2023.0,231,581,350,0.39759036144578314
Jamal Murray,2024.0,80,193,113,0.41450777202072536
Jamal Sampson,2007.0,0,1,1,0.0
Jamaree Bouyea,2023.0,2,6,4,0.3333333333333333
Jamaree Bouyea,2024.0,0,8,8,0.0
Jamario Moon,2008.0,44,133,89,0.3308270676691729
Jamario Moon,2009.0,67,185,118,0.3621621621621622
Jamario Moon,2010.0,40,116,76,0.3448275862068966
Jamario Moon,2011.0,38,123,85,0.3089430894308943
Jamario Moon,2012.0,2,10,8,0.2
Jameer Nelson,2005.0,44,141,97,0.3120567375886525
Jameer Nelson,2006.0,70,165,95,0.42424242424242425
Jameer Nelson,2007.0,70,208,138,0.33653846153846156
Jameer Nelson,2008.0,84,195,111,0.4307692307692308
Jameer Nelson,2009.0,83,187,104,0.44385026737967914
Jameer Nelson,2010.0,119,310,191,0.38387096774193546
Jameer Nelson,2011.0,125,323,198,0.38699690402476783
Jameer Nelson,2012.0,95,256,161,0.37109375
Jameer Nelson,2013.0,121,355,234,0.3408450704225352
Jameer Nelson,2014.0,136,391,255,0.34782608695652173
Jameer Nelson,2015.0,89,258,169,0.3449612403100775
Jameer Nelson,2016.0,43,144,101,0.2986111111111111
Jameer Nelson,2017.0,106,273,167,0.3882783882783883
Jameer Nelson,2018.0,41,124,83,0.33064516129032256
Jamel Artis,2018.0,8,29,21,0.27586206896551724
James Anderson,2011.0,18,46,28,0.391304347826087
James Anderson,2012.0,21,72,51,0.2916666666666667
James Anderson,2013.0,21,63,42,0.3333333333333333
James Anderson,2014.0,115,351,236,0.32763532763532766
James Anderson,2016.0,23,86,63,0.26744186046511625
James Bouknight,2022.0,17,49,32,0.3469387755102041
James Bouknight,2023.0,33,109,76,0.30275229357798167
James Bouknight,2024.0,12,26,14,0.46153846153846156
James Ennis,2015.0,31,95,64,0.3263157894736842
James Ennis,2016.0,26,58,32,0.4482758620689655
James Ennis,2017.0,57,156,99,0.36538461538461536
James Ennis,2018.0,51,153,102,0.3333333333333333
James Ennis,2019.0,64,188,124,0.3404255319148936
James Ennis,2020.0,59,185,126,0.31891891891891894
James Ennis,2021.0,45,104,59,0.4326923076923077
James Ennis,2022.0,3,8,5,0.375
James Harden,2010.0,99,264,165,0.375
James Harden,2011.0,136,400,264,0.34
James Harden,2012.0,146,370,224,0.3945945945945946
James Harden,2013.0,194,530,336,0.3660377358490566
James Harden,2014.0,193,537,344,0.35940409683426444
James Harden,2015.0,249,662,413,0.37613293051359514
James Harden,2016.0,249,699,450,0.3562231759656652
James Harden,2017.0,294,871,577,0.3375430539609644
James Harden,2018.0,317,896,579,0.35379464285714285
James Harden,2019.0,426,1165,739,0.36566523605150214
James Harden,2020.0,338,960,622,0.35208333333333336
James Harden,2021.0,145,400,255,0.3625
James Harden,2022.0,176,524,348,0.33587786259541985
James Harden,2023.0,192,500,308,0.384
James Harden,2024.0,104,254,150,0.4094488188976378
James Johnson,2010.0,15,47,32,0.3191489361702128
James Johnson,2011.0,8,34,26,0.23529411764705882
James Johnson,2012.0,19,60,41,0.31666666666666665
James Johnson,2013.0,2,21,19,0.09523809523809523
James Johnson,2014.0,24,92,68,0.2608695652173913
James Johnson,2015.0,11,51,40,0.21568627450980393
James Johnson,2016.0,24,75,51,0.32
James Johnson,2017.0,87,255,168,0.3411764705882353
James Johnson,2018.0,64,198,134,0.32323232323232326
James Johnson,2019.0,50,149,99,0.33557046979865773
James Johnson,2020.0,33,91,58,0.3626373626373626
James Johnson,2021.0,31,120,89,0.25833333333333336
James Johnson,2022.0,23,85,62,0.27058823529411763
James Johnson,2023.0,3,15,12,0.2
James Johnson,2024.0,0,1,1,0.0
James Jones,2004.0,1,4,3,0.25
James Jones,2005.0,76,191,115,0.39790575916230364
James Jones,2006.0,118,311,193,0.37942122186495175
James Jones,2007.0,98,256,158,0.3828125
James Jones,2008.0,91,205,114,0.44390243902439025
James Jones,2009.0,44,118,74,0.3728813559322034
James Jones,2010.0,37,91,54,0.4065934065934066
James Jones,2011.0,140,324,184,0.43209876543209874
James Jones,2012.0,55,144,89,0.3819444444444444
James Jones,2013.0,19,57,38,0.3333333333333333
James Jones,2014.0,43,86,43,0.5
James Jones,2015.0,85,239,154,0.35564853556485354
James Jones,2016.0,42,111,69,0.3783783783783784
James Jones,2017.0,31,69,38,0.4492753623188406
James Michael McAdoo,2016.0,1,2,1,0.5
James Michael McAdoo,2017.0,4,13,9,0.3076923076923077
James Michael McAdoo,2018.0,2,7,5,0.2857142857142857
James Nunnally,2014.0,8,25,17,0.32
James Nunnally,2019.0,8,25,17,0.32
James Nunnally,2021.0,4,12,8,0.3333333333333333
James Posey,2004.0,113,296,183,0.38175675675675674
James Posey,2005.0,62,193,131,0.32124352331606215
James Posey,2006.0,152,373,221,0.4075067024128686
James Posey,2007.0,103,278,175,0.37050359712230213
James Posey,2008.0,141,367,226,0.38419618528610355
James Posey,2009.0,121,333,212,0.3633633633633634
James Posey,2010.0,81,242,161,0.3347107438016529
James Posey,2011.0,67,212,145,0.3160377358490566
James Singleton,2006.0,10,22,12,0.45454545454545453
James Singleton,2007.0,3,14,11,0.21428571428571427
James Singleton,2009.0,15,45,30,0.3333333333333333
James Singleton,2010.0,7,37,30,0.1891891891891892
James Singleton,2012.0,2,9,7,0.2222222222222222
James Southerland,2014.0,3,6,3,0.5
James Webb,2018.0,4,19,15,0.21052631578947367
James White,2007.0,2,7,5,0.2857142857142857
James White,2009.0,2,4,2,0.5
James White,2013.0,14,43,29,0.32558139534883723
James Wiseman,2021.0,12,38,26,0.3157894736842105
James Wiseman,2023.0,4,20,16,0.2
James Wiseman,2024.0,0,2,2,0.0
James Young,2015.0,17,66,49,0.25757575757575757
James Young,2016.0,6,27,21,0.2222222222222222
James Young,2017.0,17,49,32,0.3469387755102041
James Young,2018.0,3,10,7,0.3
Jamil Wilson,2018.0,27,63,36,0.42857142857142855
Jamison Brewer,2004.0,5,14,9,0.35714285714285715
Jamison Brewer,2005.0,3,15,12,0.2
Jamorko Pickett,2022.0,13,39,26,0.3333333333333333
Jan Vesely,2012.0,0,1,1,0.0
Jan Vesely,2013.0,0,1,1,0.0
Jannero Pargo,2004.0,21,61,40,0.3442622950819672
Jannero Pargo,2005.0,36,98,62,0.3673469387755102
Jannero Pargo,2006.0,42,108,66,0.3888888888888889
Jannero Pargo,2007.0,81,209,128,0.3875598086124402
Jannero Pargo,2008.0,80,229,149,0.34934497816593885
Jannero Pargo,2010.0,39,140,101,0.2785714285714286
Jannero Pargo,2012.0,57,150,93,0.38
Jannero Pargo,2013.0,39,116,77,0.33620689655172414
Jannero Pargo,2014.0,24,60,36,0.4
Jannero Pargo,2015.0,9,22,13,0.4090909090909091
Jarace Walker,2024.0,14,35,21,0.4
Jared Butler,2022.0,28,88,60,0.3181818181818182
Jared Butler,2023.0,7,14,7,0.5
Jared Butler,2024.0,10,24,14,0.4166666666666667
Jared Cunningham,2013.0,2,3,1,0.6666666666666666
Jared Cunningham,2014.0,1,7,6,0.14285714285714285
Jared Cunningham,2015.0,4,13,9,0.3076923076923077
Jared Cunningham,2016.0,12,39,27,0.3076923076923077
Jared Dudley,2008.0,9,41,32,0.21951219512195122
Jared Dudley,2009.0,29,74,45,0.3918918918918919
Jared Dudley,2010.0,145,321,176,0.4517133956386293
Jared Dudley,2011.0,105,253,148,0.4150197628458498
Jared Dudley,2012.0,80,209,129,0.3827751196172249
Jared Dudley,2013.0,106,271,165,0.39114391143911437
Jared Dudley,2014.0,84,231,147,0.36363636363636365
Jared Dudley,2015.0,82,206,124,0.39805825242718446
Jared Dudley,2016.0,100,238,138,0.42016806722689076
Jared Dudley,2017.0,77,203,126,0.3793103448275862
Jared Dudley,2018.0,29,80,51,0.3625
Jared Dudley,2019.0,55,160,105,0.34375
Jared Dudley,2020.0,18,45,27,0.4
Jared Dudley,2021.0,2,6,4,0.3333333333333333
Jared Harper,2020.0,0,2,2,0.0
Jared Harper,2021.0,0,1,1,0.0
Jared Harper,2022.0,5,12,7,0.4166666666666667
Jared Jeffries,2004.0,5,30,25,0.16666666666666666
Jared Jeffries,2005.0,19,57,38,0.3333333333333333
Jared Jeffries,2006.0,16,56,40,0.2857142857142857
Jared Jeffries,2007.0,2,20,18,0.1
Jared Jeffries,2008.0,4,25,21,0.16
Jared Jeffries,2009.0,1,12,11,0.08333333333333333
Jared Jeffries,2010.0,21,71,50,0.29577464788732394
Jared Jeffries,2011.0,2,9,7,0.2222222222222222
Jared Jeffries,2012.0,3,16,13,0.1875
Jared Jeffries,2013.0,0,2,2,0.0
Jared Rhoden,2023.0,5,20,15,0.25
Jared Rhoden,2024.0,1,4,3,0.25
Jared Sullinger,2013.0,1,5,4,0.2
Jared Sullinger,2014.0,56,208,152,0.2692307692307692
Jared Sullinger,2015.0,55,193,138,0.2849740932642487
Jared Sullinger,2016.0,31,107,76,0.2897196261682243
Jared Sullinger,2017.0,3,18,15,0.16666666666666666
Jared Terrell,2019.0,4,17,13,0.23529411764705882
Jarell Eddie,2016.0,15,47,32,0.3191489361702128
Jarell Eddie,2017.0,4,16,12,0.25
Jarell Eddie,2018.0,0,2,2,0.0
Jarell Martin,2016.0,0,2,2,0.0
Jarell Martin,2017.0,9,26,17,0.34615384615384615
Jarell Martin,2018.0,34,98,64,0.3469387755102041
Jarell Martin,2019.0,22,64,42,0.34375
Jaren Jackson Jr.,2019.0,51,142,91,0.3591549295774648
Jaren Jackson Jr.,2020.0,145,368,223,0.39402173913043476
Jaren Jackson Jr.,2021.0,28,96,68,0.2916666666666667
Jaren Jackson Jr.,2022.0,155,473,318,0.3276955602536998
Jaren Jackson Jr.,2023.0,107,307,200,0.3485342019543974
Jaren Jackson Jr.,2024.0,76,237,161,0.3206751054852321
Jaron Blossomgame,2019.0,10,39,29,0.2564102564102564
Jarred Vanderbilt,2019.0,0,1,1,0.0
Jarred Vanderbilt,2020.0,0,1,1,0.0
Jarred Vanderbilt,2021.0,1,5,4,0.2
Jarred Vanderbilt,2022.0,2,14,12,0.14285714285714285
Jarred Vanderbilt,2023.0,36,119,83,0.3025210084033613
Jarred Vanderbilt,2024.0,6,24,18,0.25
Jarrell Brantley,2020.0,3,16,13,0.1875
Jarrell Brantley,2021.0,12,28,16,0.42857142857142855
Jarrell Brantley,2023.0,4,9,5,0.4444444444444444
Jarrett Allen,2018.0,5,15,10,0.3333333333333333
Jarrett Allen,2019.0,6,45,39,0.13333333333333333
Jarrett Allen,2020.0,0,6,6,0.0
Jarrett Allen,2021.0,6,19,13,0.3157894736842105
Jarrett Allen,2022.0,1,10,9,0.1
Jarrett Allen,2023.0,1,10,9,0.1
Jarrett Allen,2024.0,0,1,1,0.0
Jarrett Culver,2020.0,66,221,155,0.2986425339366516
Jarrett Culver,2021.0,13,53,40,0.24528301886792453
Jarrett Culver,2022.0,12,49,37,0.24489795918367346
Jarrett Culver,2023.0,1,12,11,0.08333333333333333
Jarrett Jack,2006.0,20,76,56,0.2631578947368421
Jarrett Jack,2007.0,63,180,117,0.35
Jarrett Jack,2008.0,65,190,125,0.34210526315789475
Jarrett Jack,2009.0,78,221,143,0.35294117647058826
Jarrett Jack,2010.0,82,199,117,0.4120603015075377
Jarrett Jack,2011.0,33,113,80,0.2920353982300885
Jarrett Jack,2012.0,39,112,73,0.3482142857142857
Jarrett Jack,2013.0,89,227,138,0.3920704845814978
Jarrett Jack,2014.0,63,185,122,0.34054054054054056
Jarrett Jack,2015.0,44,161,117,0.2732919254658385
Jarrett Jack,2016.0,31,102,71,0.30392156862745096
Jarrett Jack,2017.0,0,1,1,0.0
Jarrett Jack,2018.0,25,86,61,0.29069767441860467
Jarrod Uthoff,2017.0,3,9,6,0.3333333333333333
Jarrod Uthoff,2020.0,3,9,6,0.3333333333333333
Jarron Collins,2004.0,0,1,1,0.0
Jarron Collins,2005.0,0,1,1,0.0
Jarron Collins,2008.0,0,1,1,0.0
Jarron Cumberland,2022.0,0,1,1,0.0
Jarvis Hayes,2004.0,40,131,91,0.3053435114503817
Jarvis Hayes,2005.0,42,123,81,0.34146341463414637
Jarvis Hayes,2006.0,17,47,30,0.3617021276595745
Jarvis Hayes,2007.0,73,202,129,0.3613861386138614
Jarvis Hayes,2008.0,78,208,130,0.375
Jarvis Hayes,2009.0,94,244,150,0.38524590163934425
Jarvis Hayes,2010.0,60,179,119,0.33519553072625696
Jason Collier,2004.0,1,4,3,0.25
Jason Collier,2005.0,6,14,8,0.42857142857142855
Jason Collins,2004.0,0,2,2,0.0
Jason Collins,2005.0,2,6,4,0.3333333333333333
Jason Collins,2006.0,3,12,9,0.25
Jason Collins,2007.0,0,2,2,0.0
Jason Collins,2008.0,0,1,1,0.0
Jason Collins,2010.0,0,1,1,0.0
Jason Collins,2011.0,1,1,0,1.0
Jason Collins,2014.0,0,3,3,0.0
Jason Hart,2004.0,2,9,7,0.2222222222222222
Jason Hart,2005.0,35,95,60,0.3684210526315789
Jason Hart,2006.0,9,31,22,0.2903225806451613
Jason Hart,2007.0,7,29,22,0.2413793103448276
Jason Hart,2008.0,11,32,21,0.34375
Jason Hart,2009.0,0,6,6,0.0
Jason Kapono,2004.0,21,44,23,0.4772727272727273
Jason Kapono,2005.0,80,194,114,0.41237113402061853
Jason Kapono,2006.0,21,53,32,0.39622641509433965
Jason Kapono,2007.0,110,214,104,0.514018691588785
Jason Kapono,2008.0,70,142,72,0.49295774647887325
Jason Kapono,2009.0,98,229,131,0.4279475982532751
Jason Kapono,2010.0,63,171,108,0.3684210526315789
Jason Kapono,2011.0,1,8,7,0.125
Jason Kapono,2012.0,8,27,19,0.2962962962962963
Jason Kidd,2004.0,104,341,237,0.30498533724340177
Jason Kidd,2005.0,140,388,248,0.36082474226804123
Jason Kidd,2006.0,154,445,291,0.34606741573033706
Jason Kidd,2007.0,158,442,284,0.3574660633484163
Jason Kidd,2008.0,125,325,200,0.38461538461538464
Jason Kidd,2009.0,152,370,218,0.41081081081081083
Jason Kidd,2010.0,185,442,257,0.41855203619909503
Jason Kidd,2011.0,176,506,330,0.34782608695652173
Jason Kidd,2012.0,88,249,161,0.3534136546184739
Jason Kidd,2013.0,117,342,225,0.34210526315789475
Jason Maxiell,2007.0,0,1,1,0.0
Jason Maxiell,2008.0,0,1,1,0.0
Jason Maxiell,2009.0,0,1,1,0.0
Jason Maxiell,2010.0,0,1,1,0.0
Jason Maxiell,2012.0,0,2,2,0.0
Jason Preston,2023.0,5,18,13,0.2777777777777778
Jason Richardson,2004.0,77,273,196,0.28205128205128205
Jason Richardson,2005.0,125,370,245,0.33783783783783783
Jason Richardson,2006.0,183,477,294,0.3836477987421384
Jason Richardson,2007.0,139,383,244,0.3629242819843342
Jason Richardson,2008.0,243,599,356,0.4056761268781302
Jason Richardson,2009.0,129,325,196,0.39692307692307693
Jason Richardson,2010.0,205,501,296,0.4091816367265469
Jason Richardson,2011.0,197,504,307,0.39087301587301587
Jason Richardson,2012.0,112,304,192,0.3684210526315789
Jason Richardson,2013.0,57,167,110,0.3413173652694611
Jason Richardson,2015.0,31,96,65,0.3229166666666667
Jason Smith,2008.0,4,15,11,0.26666666666666666
Jason Smith,2010.0,10,29,19,0.3448275862068966
Jason Smith,2011.0,0,2,2,0.0
Jason Smith,2012.0,1,9,8,0.1111111111111111
Jason Smith,2013.0,0,4,4,0.0
Jason Smith,2015.0,15,42,27,0.35714285714285715
Jason Smith,2016.0,4,16,12,0.25
Jason Smith,2017.0,40,88,48,0.45454545454545453
Jason Smith,2018.0,4,32,28,0.125
Jason Smith,2019.0,9,26,17,0.34615384615384615
Jason Terry,2004.0,146,421,275,0.34679334916864607
Jason Terry,2005.0,130,300,170,0.43333333333333335
Jason Terry,2006.0,202,517,315,0.390715667311412
Jason Terry,2007.0,171,402,231,0.4253731343283582
Jason Terry,2008.0,150,395,245,0.379746835443038
Jason Terry,2009.0,189,515,326,0.36699029126213595
Jason Terry,2010.0,148,403,255,0.36724565756823824
Jason Terry,2011.0,169,446,277,0.3789237668161435
Jason Terry,2012.0,148,385,237,0.38441558441558443
Jason Terry,2013.0,138,365,227,0.3780821917808219
Jason Terry,2014.0,39,103,64,0.3786407766990291
Jason Terry,2015.0,155,405,250,0.38271604938271603
Jason Terry,2016.0,99,280,181,0.3535714285714286
Jason Terry,2017.0,75,182,107,0.41208791208791207
Jason Terry,2018.0,42,120,78,0.35
Jason Thompson,2009.0,0,8,8,0.0
Jason Thompson,2010.0,1,10,9,0.1
Jason Thompson,2011.0,0,3,3,0.0
Jason Thompson,2012.0,0,2,2,0.0
Jason Thompson,2013.0,0,3,3,0.0
Jason Thompson,2015.0,0,1,1,0.0
Jason Thompson,2016.0,5,16,11,0.3125
Jason Williams,2004.0,126,385,259,0.32727272727272727
Jason Williams,2005.0,117,351,234,0.3333333333333333
Jason Williams,2006.0,133,383,250,0.3472584856396867
Jason Williams,2007.0,105,312,207,0.33653846153846156
Jason Williams,2008.0,97,275,178,0.3527272727272727
Jason Williams,2010.0,90,245,155,0.3673469387755102
Jason Williams,2011.0,10,38,28,0.2631578947368421
Javaris Crittenton,2008.0,10,37,27,0.2702702702702703
Javaris Crittenton,2009.0,2,15,13,0.13333333333333333
Javon Freeman-Liberty,2024.0,4,16,12,0.25
Javonte Green,2020.0,10,35,25,0.2857142857142857
Javonte Green,2021.0,10,30,20,0.3333333333333333
Javonte Green,2022.0,36,107,71,0.3364485981308411
Javonte Green,2023.0,13,35,22,0.37142857142857144
Javonte Smart,2022.0,8,27,19,0.2962962962962963
Jawad Williams,2009.0,2,6,4,0.3333333333333333
Jawad Williams,2010.0,30,95,65,0.3157894736842105
Jawad Williams,2011.0,13,45,32,0.28888888888888886
Jawun Evans,2018.0,15,54,39,0.2777777777777778
Jawun Evans,2019.0,0,3,3,0.0
Jaxson Hayes,2020.0,1,4,3,0.25
Jaxson Hayes,2021.0,6,14,8,0.42857142857142855
Jaxson Hayes,2022.0,20,61,41,0.32786885245901637
Jaxson Hayes,2023.0,3,29,26,0.10344827586206896
Jaxson Hayes,2024.0,0,5,5,0.0
Jay Huff,2022.0,0,2,2,0.0
Jay Huff,2023.0,6,12,6,0.5
Jay Huff,2024.0,1,4,3,0.25
Jay Scrubb,2021.0,2,9,7,0.2222222222222222
Jay Scrubb,2022.0,6,21,15,0.2857142857142857
Jay Scrubb,2023.0,2,2,0,1.0
Jaylen Adams,2019.0,25,74,49,0.33783783783783783
Jaylen Adams,2020.0,0,4,4,0.0
Jaylen Adams,2021.0,0,2,2,0.0
Jaylen Brown,2017.0,51,158,107,0.3227848101265823
Jaylen Brown,2018.0,165,418,253,0.39473684210526316
Jaylen Brown,2019.0,109,316,207,0.3449367088607595
Jaylen Brown,2020.0,172,458,286,0.37554585152838427
Jaylen Brown,2021.0,163,408,245,0.39950980392156865
Jaylen Brown,2022.0,226,625,399,0.3616
Jaylen Brown,2023.0,203,600,397,0.3383333333333333
Jaylen Brown,2024.0,92,256,164,0.359375
Jaylen Clark,2024.0,12,34,22,0.35294117647058826
Jaylen Hoard,2020.0,0,3,3,0.0
Jaylen Hoard,2021.0,0,11,11,0.0
Jaylen Hoard,2022.0,9,25,16,0.36
Jaylen Martin,2024.0,0,1,1,0.0
Jaylen Morris,2018.0,2,9,7,0.2222222222222222
Jaylen Morris,2019.0,1,3,2,0.3333333333333333
Jaylen Morris,2022.0,0,2,2,0.0
Jaylen Nowell,2020.0,3,26,23,0.11538461538461539
Jaylen Nowell,2021.0,50,150,100,0.3333333333333333
Jaylen Nowell,2022.0,63,165,102,0.38181818181818183
Jaylen Nowell,2023.0,70,240,170,0.2916666666666667
Jaylen Nowell,2024.0,4,23,19,0.17391304347826086
Jaylin Williams,2023.0,46,112,66,0.4107142857142857
Jaylin Williams,2024.0,27,77,50,0.35064935064935066
Jaysean Paige,2022.0,0,2,2,0.0
Jayson Tatum,2018.0,128,313,185,0.40894568690095845
Jayson Tatum,2019.0,126,342,216,0.3684210526315789
Jayson Tatum,2020.0,236,595,359,0.39663865546218485
Jayson Tatum,2021.0,205,529,324,0.387523629489603
Jayson Tatum,2022.0,307,847,540,0.3624557260920897
Jayson Tatum,2023.0,293,851,558,0.34430082256169214
Jayson Tatum,2024.0,128,352,224,0.36363636363636365
Jeenathan Williams,2024.0,1,2,1,0.5
Jeff Adrien,2013.0,0,2,2,0.0
Jeff Ayres,2013.0,2,5,3,0.4
Jeff Ayres,2016.0,0,1,1,0.0
Jeff Dowtin,2022.0,1,9,8,0.1111111111111111
Jeff Dowtin,2023.0,5,16,11,0.3125
Jeff Foster,2004.0,0,5,5,0.0
Jeff Foster,2005.0,0,5,5,0.0
Jeff Foster,2006.0,0,4,4,0.0
Jeff Foster,2007.0,0,1,1,0.0
Jeff Foster,2008.0,0,3,3,0.0
Jeff Foster,2009.0,2,7,5,0.2857142857142857
Jeff Foster,2010.0,0,1,1,0.0
Jeff Foster,2011.0,0,3,3,0.0
Jeff Foster,2012.0,1,1,0,1.0
Jeff Green,2008.0,21,76,55,0.27631578947368424
Jeff Green,2009.0,96,247,151,0.38866396761133604
Jeff Green,2010.0,112,339,227,0.3303834808259587
Jeff Green,2011.0,71,227,156,0.31277533039647576
Jeff Green,2013.0,80,204,124,0.39215686274509803
Jeff Green,2014.0,135,396,261,0.3409090909090909
Jeff Green,2015.0,101,310,209,0.3258064516129032
Jeff Green,2016.0,71,223,152,0.3183856502242152
Jeff Green,2017.0,53,193,140,0.27461139896373055
Jeff Green,2018.0,74,240,166,0.30833333333333335
Jeff Green,2019.0,111,320,209,0.346875
Jeff Green,2020.0,85,237,152,0.35864978902953587
Jeff Green,2021.0,113,268,155,0.4216417910447761
Jeff Green,2022.0,56,176,120,0.3181818181818182
Jeff Green,2023.0,39,132,93,0.29545454545454547
Jeff Green,2024.0,16,54,38,0.2962962962962963
Jeff McInnis,2004.0,46,127,81,0.36220472440944884
Jeff McInnis,2005.0,91,264,173,0.3446969696969697
Jeff McInnis,2006.0,3,16,13,0.1875
Jeff McInnis,2007.0,1,8,7,0.125
Jeff McInnis,2008.0,3,19,16,0.15789473684210525
Jeff Taylor,2013.0,53,154,101,0.34415584415584416
Jeff Taylor,2014.0,18,67,49,0.26865671641791045
Jeff Taylor,2015.0,11,36,25,0.3055555555555556
Jeff Teague,2010.0,9,37,28,0.24324324324324326
Jeff Teague,2011.0,19,55,36,0.34545454545454546
Jeff Teague,2012.0,58,166,108,0.3493975903614458
Jeff Teague,2013.0,92,258,166,0.35658914728682173
Jeff Teague,2014.0,83,252,169,0.32936507936507936
Jeff Teague,2015.0,92,272,180,0.3382352941176471
Jeff Teague,2016.0,119,311,192,0.38263665594855306
Jeff Teague,2017.0,99,269,170,0.3680297397769517
Jeff Teague,2018.0,91,246,155,0.3699186991869919
Jeff Teague,2019.0,35,105,70,0.3333333333333333
Jeff Teague,2020.0,43,117,74,0.36752136752136755
Jeff Teague,2021.0,40,92,52,0.43478260869565216
Jeff Trepagnier,2004.0,2,4,2,0.5
Jeff Withey,2014.0,0,1,1,0.0
Jeff Withey,2016.0,0,2,2,0.0
Jeff Withey,2017.0,0,1,1,0.0
Jeff Withey,2018.0,2,10,8,0.2
Jemerrio Jones,2019.0,2,10,8,0.2
Jerami Grant,2015.0,49,156,107,0.3141025641025641
Jerami Grant,2016.0,35,146,111,0.23972602739726026
Jerami Grant,2017.0,45,122,77,0.36885245901639346
Jerami Grant,2018.0,34,118,84,0.288135593220339
Jerami Grant,2019.0,124,313,189,0.3961661341853035
Jerami Grant,2020.0,129,347,218,0.37175792507204614
Jerami Grant,2021.0,115,329,214,0.3495440729483283
Jerami Grant,2022.0,91,254,163,0.35826771653543305
Jerami Grant,2023.0,144,359,215,0.4011142061281337
Jerami Grant,2024.0,88,218,130,0.4036697247706422
Jerel McNeal,2015.0,1,2,1,0.5
Jeremiah Martin,2020.0,8,23,15,0.34782608695652173
Jeremiah Martin,2021.0,3,12,9,0.25
Jeremiah Robinson-Earl,2022.0,58,165,107,0.3515151515151515
Jeremiah Robinson-Earl,2023.0,37,111,74,0.3333333333333333
Jeremiah Robinson-Earl,2024.0,8,21,13,0.38095238095238093
Jeremy Evans,2011.0,0,1,1,0.0
Jeremy Evans,2012.0,0,1,1,0.0
Jeremy Evans,2013.0,0,1,1,0.0
Jeremy Evans,2014.0,0,2,2,0.0
Jeremy Evans,2015.0,2,5,3,0.4
Jeremy Evans,2016.0,4,16,12,0.25
Jeremy Lamb,2013.0,9,30,21,0.3
Jeremy Lamb,2014.0,90,261,171,0.3448275862068966
Jeremy Lamb,2015.0,38,111,73,0.34234234234234234
Jeremy Lamb,2016.0,57,182,125,0.3131868131868132
Jeremy Lamb,2017.0,41,147,106,0.2789115646258503
Jeremy Lamb,2018.0,94,253,159,0.3715415019762846
Jeremy Lamb,2019.0,115,330,215,0.3484848484848485
Jeremy Lamb,2020.0,53,158,105,0.33544303797468356
Jeremy Lamb,2021.0,52,125,73,0.416
Jeremy Lamb,2022.0,55,170,115,0.3235294117647059
Jeremy Lin,2011.0,1,5,4,0.2
Jeremy Lin,2012.0,24,75,51,0.32
Jeremy Lin,2013.0,89,269,180,0.3308550185873606
Jeremy Lin,2014.0,87,252,165,0.34523809523809523
Jeremy Lin,2015.0,65,176,111,0.3693181818181818
Jeremy Lin,2016.0,79,240,161,0.32916666666666666
Jeremy Lin,2017.0,55,149,94,0.3691275167785235
Jeremy Lin,2018.0,1,2,1,0.5
Jeremy Lin,2019.0,56,189,133,0.2962962962962963
Jeremy Pargo,2012.0,10,38,28,0.2631578947368421
Jeremy Pargo,2013.0,25,74,49,0.33783783783783783
Jeremy Pargo,2020.0,3,7,4,0.42857142857142855
Jeremy Richardson,2007.0,2,3,1,0.6666666666666666
Jeremy Richardson,2008.0,7,19,12,0.3684210526315789
Jeremy Richardson,2009.0,6,17,11,0.35294117647058826
Jeremy Sochan,2023.0,33,134,101,0.2462686567164179
Jeremy Sochan,2024.0,49,129,80,0.3798449612403101
Jeremy Tyler,2012.0,0,1,1,0.0
Jerian Grant,2016.0,22,100,78,0.22
Jerian Grant,2017.0,50,143,93,0.34965034965034963
Jerian Grant,2018.0,61,188,127,0.324468085106383
Jerian Grant,2019.0,40,117,77,0.3418803418803419
Jerian Grant,2020.0,2,8,6,0.25
Jericho Sims,2023.0,0,1,1,0.0
Jermaine Jackson,2005.0,0,2,2,0.0
Jermaine Jackson,2006.0,1,4,3,0.25
Jermaine O'Neal,2004.0,2,22,20,0.09090909090909091
Jermaine O'Neal,2005.0,1,9,8,0.1111111111111111
Jermaine O'Neal,2006.0,3,12,9,0.25
Jermaine O'Neal,2007.0,0,7,7,0.0
Jermaine O'Neal,2008.0,0,5,5,0.0
Jermaine O'Neal,2009.0,0,1,1,0.0
Jermaine O'Neal,2010.0,0,2,2,0.0
Jermaine O'Neal,2011.0,0,1,1,0.0
Jermaine Samuels,2024.0,0,2,2,0.0
Jermaine Taylor,2010.0,5,22,17,0.22727272727272727
Jermaine Taylor,2011.0,14,45,31,0.3111111111111111
Jerome Dyson,2012.0,1,8,7,0.125
Jerome James,2005.0,0,2,2,0.0
Jerome Moiso,2004.0,0,1,1,0.0
Jerome Moiso,2005.0,0,1,1,0.0
Jerome Robinson,2019.0,21,63,42,0.3333333333333333
Jerome Robinson,2020.0,49,153,104,0.3202614379084967
Jerome Robinson,2021.0,11,42,31,0.2619047619047619
Jerome Robinson,2024.0,0,5,5,0.0
Jerome Williams,2004.0,0,8,8,0.0
Jerome Williams,2005.0,0,5,5,0.0
Jerry Smith,2012.0,1,6,5,0.16666666666666666
Jerry Stackhouse,2004.0,23,65,42,0.35384615384615387
Jerry Stackhouse,2005.0,48,160,112,0.3
Jerry Stackhouse,2006.0,58,195,137,0.29743589743589743
Jerry Stackhouse,2007.0,73,193,120,0.37823834196891193
Jerry Stackhouse,2008.0,62,196,134,0.3163265306122449
Jerry Stackhouse,2009.0,3,19,16,0.15789473684210525
Jerry Stackhouse,2010.0,50,145,95,0.3448275862068966
Jerry Stackhouse,2011.0,1,4,3,0.25
Jerry Stackhouse,2012.0,13,38,25,0.34210526315789475
Jerry Stackhouse,2013.0,30,96,66,0.3125
Jerryd Bayless,2009.0,7,28,21,0.25
Jerryd Bayless,2010.0,35,107,72,0.32710280373831774
Jerryd Bayless,2011.0,49,146,97,0.3356164383561644
Jerryd Bayless,2012.0,44,104,60,0.4230769230769231
Jerryd Bayless,2013.0,89,260,171,0.3423076923076923
Jerryd Bayless,2014.0,76,212,136,0.3584905660377358
Jerryd Bayless,2015.0,39,127,88,0.30708661417322836
Jerryd Bayless,2016.0,101,231,130,0.43722943722943725
Jerryd Bayless,2017.0,2,5,3,0.4
Jerryd Bayless,2018.0,54,146,92,0.3698630136986301
Jerryd Bayless,2019.0,29,98,69,0.29591836734693877
Jett Howard,2024.0,4,9,5,0.4444444444444444
Jevon Carter,2019.0,34,102,68,0.3333333333333333
Jevon Carter,2020.0,62,146,84,0.4246575342465753
Jevon Carter,2021.0,56,153,97,0.3660130718954248
Jevon Carter,2022.0,69,177,108,0.3898305084745763
Jevon Carter,2023.0,143,344,201,0.41569767441860467
Jevon Carter,2024.0,54,158,104,0.34177215189873417
Jim Jackson,2004.0,170,434,264,0.391705069124424
Jim Jackson,2005.0,154,357,203,0.43137254901960786
Jim Jackson,2006.0,18,75,57,0.24
Jimmer Fredette,2012.0,78,216,138,0.3611111111111111
Jimmer Fredette,2013.0,65,156,91,0.4166666666666667
Jimmer Fredette,2014.0,40,84,44,0.47619047619047616
Jimmer Fredette,2015.0,9,48,39,0.1875
Jimmer Fredette,2016.0,1,2,1,0.5
Jimmer Fredette,2019.0,0,13,13,0.0
Jimmy Butler,2012.0,2,11,9,0.18181818181818182
Jimmy Butler,2013.0,55,142,87,0.3873239436619718
Jimmy Butler,2014.0,74,260,186,0.2846153846153846
Jimmy Butler,2015.0,101,265,164,0.38113207547169814
Jimmy Butler,2016.0,64,205,141,0.3121951219512195
Jimmy Butler,2017.0,97,270,173,0.3592592592592593
Jimmy Butler,2018.0,78,217,139,0.35944700460829493
Jimmy Butler,2019.0,79,237,158,0.3333333333333333
Jimmy Butler,2020.0,44,162,118,0.2716049382716049
Jimmy Butler,2021.0,29,117,88,0.24786324786324787
Jimmy Butler,2022.0,50,184,134,0.2717391304347826
Jimmy Butler,2023.0,64,181,117,0.35359116022099446
Jimmy Butler,2024.0,27,66,39,0.4090909090909091
Jiri Welsch,2004.0,70,185,115,0.3783783783783784
Jiri Welsch,2005.0,34,110,76,0.3090909090909091
Jiri Welsch,2006.0,14,49,35,0.2857142857142857
Joakim Noah,2008.0,0,1,1,0.0
Joakim Noah,2009.0,0,1,1,0.0
Joakim Noah,2011.0,0,1,1,0.0
Joakim Noah,2012.0,0,1,1,0.0
Joakim Noah,2013.0,0,5,5,0.0
Joakim Noah,2014.0,0,2,2,0.0
Joakim Noah,2015.0,0,2,2,0.0
Joakim Noah,2016.0,0,1,1,0.0
Joakim Noah,2017.0,0,1,1,0.0
Joakim Noah,2019.0,0,1,1,0.0
Jock Landale,2022.0,29,89,60,0.3258426966292135
Jock Landale,2023.0,21,85,64,0.24705882352941178
Jock Landale,2024.0,2,17,15,0.11764705882352941
Jodie Meeks,2010.0,42,132,90,0.3181818181818182
Jodie Meeks,2011.0,146,366,220,0.3989071038251366
Jodie Meeks,2012.0,100,279,179,0.35842293906810035
Jodie Meeks,2013.0,122,344,222,0.3546511627906977
Jodie Meeks,2014.0,162,404,242,0.400990099009901
Jodie Meeks,2015.0,74,212,138,0.3490566037735849
Jodie Meeks,2016.0,4,9,5,0.4444444444444444
Jodie Meeks,2017.0,56,137,81,0.40875912408759124
Jodie Meeks,2018.0,72,210,138,0.34285714285714286
Jodie Meeks,2019.0,10,31,21,0.3225806451612903
Joe Alexander,2009.0,16,46,30,0.34782608695652173
Joe Alexander,2010.0,0,1,1,0.0
Joe Chealey,2020.0,0,4,4,0.0
Joe Crawford,2009.0,1,4,3,0.25
Joe Harris,2015.0,32,87,55,0.367816091954023
Joe Harris,2016.0,1,4,3,0.25
Joe Harris,2017.0,85,221,136,0.38461538461538464
Joe Harris,2018.0,150,358,208,0.41899441340782123
Joe Harris,2019.0,187,407,220,0.4594594594594595
Joe Harris,2020.0,179,418,239,0.42822966507177035
Joe Harris,2021.0,244,527,283,0.4629981024667932
Joe Harris,2022.0,41,88,47,0.4659090909090909
Joe Harris,2023.0,143,345,202,0.4144927536231884
Joe Harris,2024.0,10,29,19,0.3448275862068966
Joe Ingles,2015.0,72,202,130,0.3564356435643564
Joe Ingles,2016.0,81,210,129,0.38571428571428573
Joe Ingles,2017.0,138,320,182,0.43125
Joe Ingles,2018.0,239,541,302,0.4417744916820702
Joe Ingles,2019.0,197,512,315,0.384765625
Joe Ingles,2020.0,155,393,238,0.3944020356234097
Joe Ingles,2021.0,207,464,257,0.44612068965517243
Joe Ingles,2022.0,78,225,147,0.3466666666666667
Joe Ingles,2023.0,93,223,130,0.4170403587443946
Joe Ingles,2024.0,34,86,52,0.3953488372093023
Joe Johnson,2004.0,83,272,189,0.30514705882352944
Joe Johnson,2005.0,197,406,209,0.4852216748768473
Joe Johnson,2006.0,124,356,232,0.34831460674157305
Joe Johnson,2007.0,119,312,193,0.3814102564102564
Joe Johnson,2008.0,185,480,295,0.3854166666666667
Joe Johnson,2009.0,161,449,288,0.3585746102449889
Joe Johnson,2010.0,138,391,253,0.35294117647058826
Joe Johnson,2011.0,107,342,235,0.3128654970760234
Joe Johnson,2012.0,134,358,224,0.3743016759776536
Joe Johnson,2013.0,158,434,276,0.3640552995391705
Joe Johnson,2014.0,184,457,273,0.4026258205689278
Joe Johnson,2015.0,133,378,245,0.35185185185185186
Joe Johnson,2016.0,133,359,226,0.37047353760445684
Joe Johnson,2017.0,121,304,183,0.3980263157894737
Joe Johnson,2018.0,40,148,108,0.2702702702702703
Joe Smith,2004.0,1,6,5,0.16666666666666666
Joe Smith,2005.0,0,1,1,0.0
Joe Smith,2006.0,0,2,2,0.0
Joe Smith,2007.0,0,5,5,0.0
Joe Smith,2008.0,0,4,4,0.0
Joe Smith,2009.0,6,12,6,0.5
Joe Smith,2010.0,1,7,6,0.14285714285714285
Joe Wieskamp,2022.0,14,43,29,0.32558139534883723
Joe Wieskamp,2023.0,3,12,9,0.25
Joel Ayayi,2022.0,0,1,1,0.0
Joel Bolomboy,2017.0,1,4,3,0.25
Joel Bolomboy,2018.0,0,1,1,0.0
Joel Embiid,2017.0,36,98,62,0.3673469387755102
Joel Embiid,2018.0,74,243,169,0.3045267489711934
Joel Embiid,2019.0,91,302,211,0.30132450331125826
Joel Embiid,2020.0,61,188,127,0.324468085106383
Joel Embiid,2021.0,74,196,122,0.37755102040816324
Joel Embiid,2022.0,100,284,184,0.352112676056338
Joel Embiid,2023.0,71,228,157,0.31140350877192985
Joel Embiid,2024.0,39,106,67,0.36792452830188677
Joel Freeland,2014.0,0,2,2,0.0
Joel Przybilla,2008.0,0,1,1,0.0
Joel Przybilla,2009.0,0,1,1,0.0
Joey Dorsey,2015.0,0,1,1,0.0
Joey Graham,2006.0,29,87,58,0.3333333333333333
Joey Graham,2007.0,9,32,23,0.28125
Joey Graham,2008.0,2,4,2,0.5
Joey Graham,2009.0,3,16,13,0.1875
Joey Graham,2010.0,3,16,13,0.1875
Joey Graham,2011.0,9,30,21,0.3
Joffrey Lauvergne,2015.0,3,16,13,0.1875
Joffrey Lauvergne,2016.0,13,53,40,0.24528301886792453
Joffrey Lauvergne,2017.0,33,100,67,0.33
Joffrey Lauvergne,2018.0,0,5,5,0.0
Johan Petro,2008.0,0,1,1,0.0
Johan Petro,2009.0,0,2,2,0.0
Johan Petro,2010.0,0,1,1,0.0
Johan Petro,2011.0,0,4,4,0.0
Johan Petro,2012.0,1,1,0,1.0
Johan Petro,2013.0,1,4,3,0.25
John Butler,2023.0,8,35,27,0.22857142857142856
John Collins,2018.0,16,47,31,0.3404255319148936
John Collins,2019.0,55,158,103,0.34810126582278483
John Collins,2020.0,59,147,88,0.4013605442176871
John Collins,2021.0,103,264,161,0.39015151515151514
John Collins,2022.0,68,187,119,0.36363636363636365
John Collins,2023.0,81,272,191,0.2977941176470588
John Collins,2024.0,54,155,101,0.34838709677419355
John Henson,2013.0,0,4,4,0.0
John Henson,2014.0,0,1,1,0.0
John Henson,2015.0,0,1,1,0.0
John Henson,2016.0,0,1,1,0.0
John Henson,2017.0,0,1,1,0.0
John Henson,2018.0,1,7,6,0.14285714285714285
John Henson,2019.0,11,31,20,0.3548387096774194
John Henson,2020.0,8,36,28,0.2222222222222222
John Holland,2016.0,0,1,1,0.0
John Holland,2018.0,11,36,25,0.3055555555555556
John Jenkins,2013.0,53,139,86,0.381294964028777
John Jenkins,2014.0,4,18,14,0.2222222222222222
John Jenkins,2015.0,23,56,33,0.4107142857142857
John Jenkins,2016.0,16,51,35,0.3137254901960784
John Jenkins,2017.0,1,2,1,0.5
John Jenkins,2019.0,22,59,37,0.3728813559322034
John Konchar,2020.0,5,10,5,0.5
John Konchar,2021.0,21,57,36,0.3684210526315789
John Konchar,2022.0,53,132,79,0.4015151515151515
John Konchar,2023.0,60,181,121,0.3314917127071823
John Konchar,2024.0,22,73,51,0.3013698630136986
John Lucas III,2006.0,2,9,7,0.2222222222222222
John Lucas III,2007.0,15,60,45,0.25
John Lucas III,2011.0,0,1,1,0.0
John Lucas III,2012.0,60,153,93,0.39215686274509803
John Lucas III,2013.0,57,151,94,0.37748344370860926
John Lucas III,2014.0,25,84,59,0.2976190476190476
John Lucas III,2015.0,9,29,20,0.3103448275862069
John Lucas III,2017.0,0,1,1,0.0
John Salmons,2004.0,49,145,96,0.33793103448275863
John Salmons,2005.0,31,91,60,0.34065934065934067
John Salmons,2006.0,26,87,61,0.2988505747126437
John Salmons,2007.0,40,112,72,0.35714285714285715
John Salmons,2008.0,39,120,81,0.325
John Salmons,2009.0,138,340,202,0.40588235294117647
John Salmons,2010.0,122,332,210,0.3674698795180723
John Salmons,2011.0,83,219,136,0.3789954337899543
John Salmons,2012.0,33,112,79,0.29464285714285715
John Salmons,2013.0,99,267,168,0.3707865168539326
John Salmons,2014.0,65,175,110,0.37142857142857144
John Salmons,2015.0,8,26,18,0.3076923076923077
John Wall,2011.0,34,115,81,0.2956521739130435
John Wall,2012.0,3,42,39,0.07142857142857142
John Wall,2013.0,12,45,33,0.26666666666666666
John Wall,2014.0,115,340,225,0.3382352941176471
John Wall,2015.0,68,234,166,0.2905982905982906
John Wall,2016.0,115,328,213,0.35060975609756095
John Wall,2017.0,110,332,222,0.3313253012048193
John Wall,2018.0,66,188,122,0.35106382978723405
John Wall,2019.0,51,169,118,0.30177514792899407
John Wall,2021.0,79,249,170,0.3172690763052209
John Wall,2023.0,33,109,76,0.30275229357798167
John Wallace,2004.0,4,12,8,0.3333333333333333
Johnathan Motley,2018.0,1,6,5,0.16666666666666666
Johnathan Motley,2019.0,0,3,3,0.0
Johnathan Motley,2020.0,1,1,0,1.0
Johnathan Williams,2019.0,0,2,2,0.0
Johnathan Williams,2020.0,0,2,2,0.0
Johnny Davis,2023.0,17,70,53,0.24285714285714285
Johnny Davis,2024.0,1,3,2,0.3333333333333333
Johnny Juzang,2023.0,15,63,48,0.23809523809523808
Johnny Juzang,2024.0,0,2,2,0.0
Johnny O'Bryant,2016.0,1,1,0,1.0
Johnny O'Bryant,2017.0,3,6,3,0.5
Johnny O'Bryant,2018.0,14,43,29,0.32558139534883723
Jon Barry,2004.0,54,147,93,0.3673469387755102
Jon Barry,2005.0,82,188,106,0.43617021276595747
Jon Barry,2006.0,12,32,20,0.375
Jon Brockman,2012.0,0,1,1,0.0
Jon Leuer,2012.0,3,9,6,0.3333333333333333
Jon Leuer,2013.0,0,3,3,0.0
Jon Leuer,2014.0,24,51,27,0.47058823529411764
Jon Leuer,2015.0,7,29,22,0.2413793103448276
Jon Leuer,2016.0,42,110,68,0.38181818181818183
Jon Leuer,2017.0,49,167,118,0.2934131736526946
Jon Leuer,2018.0,0,3,3,0.0
Jon Leuer,2019.0,1,12,11,0.08333333333333333
Jonah Bolden,2019.0,38,112,74,0.3392857142857143
Jonah Bolden,2020.0,0,4,4,0.0
Jonas Jerebko,2010.0,36,115,79,0.3130434782608696
Jonas Jerebko,2012.0,32,106,74,0.3018867924528302
Jonas Jerebko,2013.0,25,81,56,0.30864197530864196
Jonas Jerebko,2014.0,31,74,43,0.4189189189189189
Jonas Jerebko,2015.0,54,144,90,0.375
Jonas Jerebko,2016.0,50,130,80,0.38461538461538464
Jonas Jerebko,2017.0,50,145,95,0.3448275862068966
Jonas Jerebko,2018.0,66,163,97,0.4049079754601227
Jonas Jerebko,2019.0,74,207,133,0.357487922705314
Jonas Valanciunas,2014.0,0,1,1,0.0
Jonas Valanciunas,2015.0,0,1,1,0.0
Jonas Valanciunas,2017.0,1,3,2,0.3333333333333333
Jonas Valanciunas,2018.0,32,79,47,0.4050632911392405
Jonas Valanciunas,2019.0,14,48,34,0.2916666666666667
Jonas Valanciunas,2020.0,32,95,63,0.3368421052631579
Jonas Valanciunas,2021.0,24,67,43,0.3582089552238806
Jonas Valanciunas,2022.0,58,167,109,0.3473053892215569
Jonas Valanciunas,2023.0,38,109,71,0.3486238532110092
Jonas Valanciunas,2024.0,30,84,54,0.35714285714285715
Jonathan Bender,2004.0,18,47,29,0.3829787234042553
Jonathan Bender,2005.0,1,5,4,0.2
Jonathan Bender,2010.0,14,39,25,0.358974358974359
Jonathan Gibson,2017.0,15,45,30,0.3333333333333333
Jonathan Gibson,2018.0,6,12,6,0.5
Jonathan Isaac,2018.0,16,46,30,0.34782608695652173
Jonathan Isaac,2019.0,90,286,196,0.3146853146853147
Jonathan Isaac,2020.0,32,94,62,0.3404255319148936
Jonathan Isaac,2023.0,6,15,9,0.4
Jonathan Isaac,2024.0,16,56,40,0.2857142857142857
Jonathan Kuminga,2022.0,53,162,109,0.3271604938271605
Jonathan Kuminga,2023.0,57,153,96,0.37254901960784315
Jonathan Kuminga,2024.0,35,108,73,0.32407407407407407
Jonathon Simmons,2016.0,20,50,30,0.4
Jonathon Simmons,2017.0,43,139,96,0.30935251798561153
Jonathon Simmons,2018.0,69,204,135,0.3382352941176471
Jonathon Simmons,2019.0,30,114,84,0.2631578947368421
Jonny Flynn,2010.0,77,215,138,0.3581395348837209
Jonny Flynn,2011.0,31,100,69,0.31
Jonny Flynn,2012.0,10,34,24,0.29411764705882354
Jontay Porter,2021.0,3,8,5,0.375
Jontay Porter,2024.0,11,33,22,0.3333333333333333
Jordan Adams,2015.0,11,26,15,0.4230769230769231
Jordan Adams,2016.0,0,1,1,0.0
Jordan Bell,2018.0,0,5,5,0.0
Jordan Bell,2019.0,0,2,2,0.0
Jordan Bell,2020.0,4,12,8,0.3333333333333333
Jordan Bell,2021.0,0,2,2,0.0
Jordan Bone,2020.0,2,10,8,0.2
Jordan Bone,2021.0,10,32,22,0.3125
Jordan Clarkson,2015.0,38,121,83,0.3140495867768595
Jordan Clarkson,2016.0,111,320,209,0.346875
Jordan Clarkson,2017.0,116,355,239,0.3267605633802817
Jordan Clarkson,2018.0,123,364,241,0.33791208791208793
Jordan Clarkson,2019.0,144,445,301,0.3235955056179775
Jordan Clarkson,2020.0,169,462,293,0.3658008658008658
Jordan Clarkson,2021.0,242,696,454,0.34770114942528735
Jordan Clarkson,2022.0,199,621,422,0.32045088566827695
Jordan Clarkson,2023.0,155,459,304,0.33769063180827885
Jordan Clarkson,2024.0,64,207,143,0.30917874396135264
Jordan Crawford,2011.0,33,128,95,0.2578125
Jordan Crawford,2012.0,79,273,194,0.2893772893772894
Jordan Crawford,2013.0,86,258,172,0.3333333333333333
Jordan Crawford,2014.0,92,292,200,0.3150684931506849
Jordan Crawford,2017.0,37,95,58,0.3894736842105263
Jordan Crawford,2018.0,11,22,11,0.5
Jordan Farmar,2007.0,47,147,100,0.3197278911564626
Jordan Farmar,2008.0,131,351,220,0.3732193732193732
Jordan Farmar,2009.0,61,185,124,0.32972972972972975
Jordan Farmar,2010.0,106,279,173,0.37992831541218636
Jordan Farmar,2011.0,109,304,195,0.35855263157894735
Jordan Farmar,2012.0,55,125,70,0.44
Jordan Farmar,2014.0,70,160,90,0.4375
Jordan Farmar,2015.0,35,97,62,0.36082474226804123
Jordan Farmar,2016.0,20,57,37,0.3508771929824561
Jordan Farmar,2017.0,4,9,5,0.4444444444444444
Jordan Ford,2024.0,2,3,1,0.6666666666666666
Jordan Goodwin,2022.0,0,1,1,0.0
Jordan Goodwin,2023.0,38,118,80,0.3220338983050847
Jordan Goodwin,2024.0,23,80,57,0.2875
Jordan Hall,2023.0,3,15,12,0.2
Jordan Hamilton,2012.0,17,47,30,0.3617021276595745
Jordan Hamilton,2013.0,27,73,46,0.3698630136986301
Jordan Hamilton,2014.0,70,198,128,0.35353535353535354
Jordan Hamilton,2015.0,10,21,11,0.47619047619047616
Jordan Hamilton,2016.0,13,45,32,0.28888888888888886
Jordan Hawkins,2024.0,59,142,83,0.4154929577464789
Jordan Hill,2010.0,0,2,2,0.0
Jordan Hill,2011.0,0,2,2,0.0
Jordan Hill,2012.0,0,3,3,0.0
Jordan Hill,2013.0,0,2,2,0.0
Jordan Hill,2014.0,0,1,1,0.0
Jordan Hill,2015.0,3,11,8,0.2727272727272727
Jordan Hill,2016.0,0,1,1,0.0
Jordan Loyd,2019.0,4,8,4,0.5
Jordan McLaughlin,2020.0,29,76,47,0.3815789473684211
Jordan McLaughlin,2021.0,33,92,59,0.358695652173913
Jordan McLaughlin,2022.0,31,92,61,0.33695652173913043
Jordan McLaughlin,2023.0,24,80,56,0.3
Jordan McLaughlin,2024.0,11,31,20,0.3548387096774194
Jordan McRae,2016.0,11,23,12,0.4782608695652174
Jordan McRae,2017.0,18,51,33,0.35294117647058826
Jordan McRae,2019.0,10,35,25,0.2857142857142857
Jordan McRae,2020.0,45,126,81,0.35714285714285715
Jordan Mickey,2017.0,0,1,1,0.0
Jordan Mickey,2018.0,2,16,14,0.125
Jordan Miller,2024.0,0,2,2,0.0
Jordan Nwora,2021.0,30,70,40,0.42857142857142855
Jordan Nwora,2022.0,79,231,152,0.341991341991342
Jordan Nwora,2023.0,86,211,125,0.4075829383886256
Jordan Nwora,2024.0,15,47,32,0.3191489361702128
Jordan Poole,2020.0,74,265,191,0.2792452830188679
Jordan Poole,2021.0,102,286,184,0.35664335664335667
Jordan Poole,2022.0,261,708,447,0.3686440677966102
Jordan Poole,2023.0,230,700,470,0.32857142857142857
Jordan Poole,2024.0,87,277,190,0.3140794223826715
Jordan Schakel,2022.0,1,6,5,0.16666666666666666
Jordan Schakel,2023.0,1,1,0,1.0
Jordan Sibert,2019.0,1,1,0,1.0
Jordan Walsh,2024.0,0,1,1,0.0
Jorge Garbajosa,2007.0,66,193,127,0.34196891191709844
Jorge Garbajosa,2008.0,6,16,10,0.375
Jorge Gutierrez,2014.0,3,12,9,0.25
Jorge Gutierrez,2015.0,0,3,3,0.0
Jorge Gutierrez,2016.0,0,2,2,0.0
Jose Alvarado,2022.0,41,131,90,0.31297709923664124
Jose Alvarado,2023.0,83,247,164,0.3360323886639676
Jose Alvarado,2024.0,37,97,60,0.38144329896907214
Jose Calderon,2006.0,7,43,36,0.16279069767441862
Jose Calderon,2007.0,28,87,59,0.3218390804597701
Jose Calderon,2008.0,89,205,116,0.43414634146341463
Jose Calderon,2009.0,82,202,120,0.40594059405940597
Jose Calderon,2010.0,68,171,103,0.39766081871345027
Jose Calderon,2011.0,57,156,99,0.36538461538461536
Jose Calderon,2012.0,59,159,100,0.3710691823899371
Jose Calderon,2013.0,127,277,150,0.4584837545126354
Jose Calderon,2014.0,202,448,246,0.45089285714285715
Jose Calderon,2015.0,59,142,83,0.4154929577464789
Jose Calderon,2016.0,84,203,119,0.41379310344827586
Jose Calderon,2017.0,24,76,52,0.3157894736842105
Jose Calderon,2018.0,49,115,66,0.4260869565217391
Jose Calderon,2019.0,14,57,43,0.24561403508771928
Joseph Young,2016.0,11,50,39,0.22
Joseph Young,2017.0,5,23,18,0.21739130434782608
Joseph Young,2018.0,25,66,41,0.3787878787878788
Josh Akognon,2013.0,1,2,1,0.5
Josh Childress,2005.0,13,56,43,0.23214285714285715
Josh Childress,2006.0,32,65,33,0.49230769230769234
Josh Childress,2007.0,26,77,51,0.33766233766233766
Josh Childress,2008.0,22,62,40,0.3548387096774194
Josh Childress,2011.0,1,16,15,0.0625
Josh Childress,2012.0,4,24,20,0.16666666666666666
Josh Childress,2013.0,1,3,2,0.3333333333333333
Josh Christopher,2022.0,56,189,133,0.2962962962962963
Josh Christopher,2023.0,21,89,68,0.23595505617977527
Josh Davis,2004.0,0,2,2,0.0
Josh Davis,2005.0,19,54,35,0.35185185185185186
Josh Davis,2006.0,0,2,2,0.0
Josh Davis,2012.0,4,13,9,0.3076923076923077
Josh Giddey,2022.0,56,213,157,0.26291079812206575
Josh Giddey,2023.0,76,234,158,0.3247863247863248
Josh Giddey,2024.0,40,121,81,0.3305785123966942
Josh Gray,2018.0,3,13,10,0.23076923076923078
Josh Green,2021.0,4,25,21,0.16
Josh Green,2022.0,33,100,67,0.33
Josh Green,2023.0,68,169,101,0.40236686390532544
Josh Green,2024.0,44,111,67,0.3963963963963964
Josh Hall,2021.0,4,37,33,0.10810810810810811
Josh Harrellson,2012.0,20,60,40,0.3333333333333333
Josh Harrellson,2013.0,1,5,4,0.2
Josh Harrellson,2014.0,12,31,19,0.3870967741935484
Josh Hart,2018.0,78,197,119,0.39593908629441626
Josh Hart,2019.0,92,274,182,0.3357664233576642
Josh Hart,2020.0,121,354,233,0.3418079096045198
Josh Hart,2021.0,63,193,130,0.32642487046632124
Josh Hart,2022.0,73,213,140,0.3427230046948357
Josh Hart,2023.0,71,196,125,0.3622448979591837
Josh Hart,2024.0,40,124,84,0.3225806451612903
Josh Howard,2004.0,21,71,50,0.29577464788732394
Josh Howard,2005.0,38,131,93,0.2900763358778626
Josh Howard,2006.0,51,128,77,0.3984375
Josh Howard,2007.0,99,257,158,0.3852140077821012
Josh Howard,2008.0,68,220,152,0.3090909090909091
Josh Howard,2009.0,66,200,134,0.33
Josh Howard,2010.0,23,86,63,0.26744186046511625
Josh Howard,2011.0,7,29,22,0.2413793103448276
Josh Howard,2012.0,10,39,29,0.2564102564102564
Josh Howard,2013.0,5,16,11,0.3125
Josh Huestis,2016.0,5,8,3,0.625
Josh Huestis,2017.0,2,4,2,0.5
Josh Huestis,2018.0,33,115,82,0.28695652173913044
Josh Jackson,2018.0,57,217,160,0.2626728110599078
Josh Jackson,2019.0,73,225,152,0.3244444444444444
Josh Jackson,2020.0,23,72,49,0.3194444444444444
Josh Jackson,2021.0,77,257,180,0.29961089494163423
Josh Jackson,2022.0,33,130,97,0.25384615384615383
Josh Magette,2018.0,8,22,14,0.36363636363636365
Josh Magette,2020.0,1,4,3,0.25
Josh McRoberts,2008.0,0,1,1,0.0
Josh McRoberts,2009.0,0,10,10,0.0
Josh McRoberts,2010.0,8,23,15,0.34782608695652173
Josh McRoberts,2011.0,23,61,38,0.3770491803278688
Josh McRoberts,2012.0,3,8,5,0.375
Josh McRoberts,2013.0,24,84,60,0.2857142857142857
Josh McRoberts,2014.0,113,308,195,0.36688311688311687
Josh McRoberts,2015.0,8,19,11,0.42105263157894735
Josh McRoberts,2016.0,12,56,44,0.21428571428571427
Josh McRoberts,2017.0,13,31,18,0.41935483870967744
Josh McRoberts,2018.0,0,1,1,0.0
Josh Minott,2023.0,2,7,5,0.2857142857142857
Josh Minott,2024.0,0,5,5,0.0
Josh Okogie,2019.0,60,215,155,0.27906976744186046
Josh Okogie,2020.0,41,154,113,0.2662337662337662
Josh Okogie,2021.0,29,108,79,0.26851851851851855
Josh Okogie,2022.0,14,47,33,0.2978723404255319
Josh Okogie,2023.0,68,211,143,0.3222748815165877
Josh Okogie,2024.0,17,71,54,0.23943661971830985
Josh Powell,2008.0,0,3,3,0.0
Josh Powell,2009.0,1,1,0,1.0
Josh Powell,2010.0,7,17,10,0.4117647058823529
Josh Powell,2011.0,0,1,1,0.0
Josh Reaves,2020.0,0,3,3,0.0
Josh Richardson,2016.0,70,161,91,0.43478260869565216
Josh Richardson,2017.0,75,225,150,0.3333333333333333
Josh Richardson,2018.0,133,355,222,0.37464788732394366
Josh Richardson,2019.0,164,459,295,0.3572984749455338
Josh Richardson,2020.0,95,277,182,0.34296028880866425
Josh Richardson,2021.0,91,277,186,0.3285198555956679
Josh Richardson,2022.0,104,250,146,0.416
Josh Richardson,2023.0,107,293,186,0.3651877133105802
Josh Richardson,2024.0,51,153,102,0.3333333333333333
Josh Selby,2012.0,2,15,13,0.13333333333333333
Josh Selby,2013.0,1,6,5,0.16666666666666666
Josh Smith,2005.0,4,23,19,0.17391304347826086
Josh Smith,2006.0,34,110,76,0.3090909090909091
Josh Smith,2007.0,38,152,114,0.25
Josh Smith,2008.0,28,117,89,0.23931623931623933
Josh Smith,2009.0,28,102,74,0.27450980392156865
Josh Smith,2010.0,2,13,11,0.15384615384615385
Josh Smith,2011.0,54,178,124,0.30337078651685395
Josh Smith,2012.0,28,113,85,0.24778761061946902
Josh Smith,2013.0,66,221,155,0.2986425339366516
Josh Smith,2014.0,70,265,195,0.2641509433962264
Josh Smith,2015.0,99,299,200,0.3311036789297659
Josh Smith,2016.0,45,151,106,0.2980132450331126
Joshua Primo,2022.0,42,137,95,0.30656934306569344
Joshua Primo,2023.0,3,12,9,0.25
Joshua Primo,2024.0,0,1,1,0.0
Jrue Holiday,2010.0,62,159,97,0.389937106918239
Jrue Holiday,2011.0,92,243,151,0.3786008230452675
Jrue Holiday,2012.0,85,220,135,0.38636363636363635
Jrue Holiday,2013.0,91,247,156,0.3684210526315789
Jrue Holiday,2014.0,30,77,47,0.38961038961038963
Jrue Holiday,2015.0,52,139,87,0.37410071942446044
Jrue Holiday,2016.0,87,259,172,0.3359073359073359
Jrue Holiday,2017.0,100,281,181,0.35587188612099646
Jrue Holiday,2018.0,136,406,270,0.33497536945812806
Jrue Holiday,2019.0,118,363,245,0.325068870523416
Jrue Holiday,2020.0,122,346,224,0.35260115606936415
Jrue Holiday,2021.0,154,425,271,0.3623529411764706
Jrue Holiday,2022.0,157,400,243,0.3925
Jrue Holiday,2023.0,170,453,283,0.37527593818984545
Jrue Holiday,2024.0,86,207,121,0.41545893719806765
Juan Carlos Navarro,2008.0,156,432,276,0.3611111111111111
Juan Dixon,2004.0,59,198,139,0.29797979797979796
Juan Dixon,2005.0,59,181,122,0.3259668508287293
Juan Dixon,2006.0,65,170,105,0.38235294117647056
Juan Dixon,2007.0,81,234,153,0.34615384615384615
Juan Dixon,2008.0,30,72,42,0.4166666666666667
Juan Dixon,2009.0,25,75,50,0.3333333333333333
Juan Hernangomez,2017.0,46,111,65,0.4144144144144144
Juan Hernangomez,2018.0,14,50,36,0.28
Juan Hernangomez,2019.0,67,183,116,0.366120218579235
Juan Hernangomez,2020.0,44,129,85,0.34108527131782945
Juan Hernangomez,2021.0,55,168,113,0.3273809523809524
Juan Hernangomez,2022.0,28,81,53,0.345679012345679
Juan Hernangomez,2023.0,17,67,50,0.2537313432835821
Juan Toscano-Anderson,2020.0,8,23,15,0.34782608695652173
Juan Toscano-Anderson,2021.0,39,99,60,0.3939393939393939
Juan Toscano-Anderson,2022.0,30,92,62,0.32608695652173914
Juan Toscano-Anderson,2023.0,8,43,35,0.18604651162790697
Juan Toscano-Anderson,2024.0,1,4,3,0.25
Jules Bernard,2024.0,0,7,7,0.0
Julian Champagnie,2023.0,33,82,49,0.4024390243902439
Julian Champagnie,2024.0,54,137,83,0.39416058394160586
Julian Phillips,2023.0,1,7,6,0.14285714285714285
Julian Phillips,2024.0,2,15,13,0.13333333333333333
Julian Strawther,2024.0,37,115,78,0.3217391304347826
Julian Washburn,2019.0,5,24,19,0.20833333333333334
Julian Wright,2008.0,12,33,21,0.36363636363636365
Julian Wright,2009.0,2,21,19,0.09523809523809523
Julian Wright,2010.0,2,6,4,0.3333333333333333
Julian Wright,2011.0,2,10,8,0.2
Julius Randle,2016.0,10,36,26,0.2777777777777778
Julius Randle,2017.0,17,64,47,0.265625
Julius Randle,2018.0,10,45,35,0.2222222222222222
Julius Randle,2019.0,67,195,128,0.3435897435897436
Julius Randle,2020.0,64,231,167,0.27705627705627706
Julius Randle,2021.0,171,422,251,0.4052132701421801
Julius Randle,2022.0,120,390,270,0.3076923076923077
Julius Randle,2023.0,235,702,467,0.33475783475783477
Julius Randle,2024.0,76,244,168,0.3114754098360656
Julyan Stone,2012.0,2,11,9,0.18181818181818182
Julyan Stone,2014.0,2,8,6,0.25
Julyan Stone,2018.0,6,13,7,0.46153846153846156
Jumaine Jones,2004.0,13,46,33,0.2826086956521739
Jumaine Jones,2005.0,102,261,159,0.39080459770114945
Jumaine Jones,2006.0,113,329,216,0.3434650455927052
Jumaine Jones,2007.0,10,32,22,0.3125
Junior Harrington,2005.0,6,19,13,0.3157894736842105
Junior Harrington,2007.0,7,26,19,0.2692307692307692
Justin Anderson,2016.0,26,96,70,0.2708333333333333
Justin Anderson,2017.0,58,193,135,0.3005181347150259
Justin Anderson,2018.0,36,110,74,0.32727272727272727
Justin Anderson,2019.0,24,77,53,0.3116883116883117
Justin Anderson,2020.0,11,40,29,0.275
Justin Anderson,2022.0,15,59,44,0.2542372881355932
Justin Champagnie,2022.0,10,28,18,0.35714285714285715
Justin Champagnie,2023.0,1,8,7,0.125
Justin Dentmon,2012.0,2,14,12,0.14285714285714285
Justin Hamilton,2014.0,3,9,6,0.3333333333333333
Justin Hamilton,2015.0,10,31,21,0.3225806451612903
Justin Hamilton,2017.0,55,181,126,0.30386740331491713
Justin Harper,2012.0,2,13,11,0.15384615384615385
Justin Harper,2016.0,4,9,5,0.4444444444444444
Justin Harper,2017.0,2,7,5,0.2857142857142857
Justin Holiday,2013.0,4,16,12,0.25
Justin Holiday,2015.0,36,110,74,0.32727272727272727
Justin Holiday,2016.0,36,105,69,0.34285714285714286
Justin Holiday,2017.0,97,273,176,0.3553113553113553
Justin Holiday,2018.0,161,449,288,0.3585746102449889
Justin Holiday,2019.0,162,465,303,0.34838709677419355
Justin Holiday,2020.0,142,347,205,0.4092219020172911
Justin Holiday,2021.0,171,454,283,0.3766519823788546
Justin Holiday,2022.0,177,482,305,0.36721991701244816
Justin Holiday,2023.0,46,143,97,0.32167832167832167
Justin Holiday,2024.0,21,49,28,0.42857142857142855
Justin Jackson,2018.0,57,185,128,0.3081081081081081
Justin Jackson,2019.0,87,245,158,0.3551020408163265
Justin Jackson,2020.0,48,166,118,0.2891566265060241
Justin Jackson,2021.0,36,119,83,0.3025210084033613
Justin Jackson,2022.0,3,9,6,0.3333333333333333
Justin Jackson,2023.0,5,20,15,0.25
Justin James,2020.0,9,29,20,0.3103448275862069
Justin James,2021.0,14,38,24,0.3684210526315789
Justin Minaya,2024.0,8,24,16,0.3333333333333333
Justin Patton,2019.0,0,2,2,0.0
Justin Patton,2020.0,1,4,3,0.25
Justin Patton,2021.0,9,34,25,0.2647058823529412
Justin Reed,2005.0,0,5,5,0.0
Justin Reed,2006.0,0,1,1,0.0
Justin Robinson,2020.0,3,5,2,0.6
Justin Robinson,2021.0,4,14,10,0.2857142857142857
Justin Robinson,2022.0,18,61,43,0.29508196721311475
Justin Williams,2007.0,0,1,1,0.0
Justin Wright-Foreman,2020.0,2,10,8,0.2
Justise Winslow,2016.0,37,134,97,0.27611940298507465
Justise Winslow,2017.0,7,37,30,0.1891891891891892
Justise Winslow,2018.0,56,148,92,0.3783783783783784
Justise Winslow,2019.0,96,256,160,0.375
Justise Winslow,2020.0,6,27,21,0.2222222222222222
Justise Winslow,2021.0,10,54,44,0.18518518518518517
Justise Winslow,2022.0,15,66,51,0.22727272727272727
Justise Winslow,2023.0,14,45,31,0.3111111111111111
Jusuf Nurkic,2015.0,0,2,2,0.0
Jusuf Nurkic,2016.0,0,3,3,0.0
Jusuf Nurkic,2017.0,0,2,2,0.0
Jusuf Nurkic,2018.0,0,7,7,0.0
Jusuf Nurkic,2019.0,3,29,26,0.10344827586206896
Jusuf Nurkic,2020.0,7,24,17,0.2916666666666667
Jusuf Nurkic,2021.0,13,35,22,0.37142857142857144
Jusuf Nurkic,2022.0,15,56,41,0.26785714285714285
Jusuf Nurkic,2023.0,43,119,76,0.36134453781512604
Jusuf Nurkic,2024.0,21,78,57,0.2692307692307692
Juwan Howard,2004.0,0,1,1,0.0
Juwan Howard,2005.0,0,1,1,0.0
Juwan Howard,2006.0,0,4,4,0.0
Juwan Howard,2010.0,0,1,1,0.0
Juwan Morgan,2020.0,5,18,13,0.2777777777777778
Juwan Morgan,2021.0,4,13,9,0.3076923076923077
Juwan Morgan,2022.0,1,3,2,0.3333333333333333
K.J. McDaniels,2015.0,43,150,107,0.2866666666666667
K.J. McDaniels,2016.0,8,28,20,0.2857142857142857
K.J. McDaniels,2017.0,20,66,46,0.30303030303030304
KZ Okpala,2020.0,0,1,1,0.0
KZ Okpala,2021.0,12,51,39,0.23529411764705882
KZ Okpala,2022.0,9,26,17,0.34615384615384615
KZ Okpala,2023.0,7,21,14,0.3333333333333333
Kadeem Allen,2018.0,0,11,11,0.0
Kadeem Allen,2019.0,17,36,19,0.4722222222222222
Kadeem Allen,2020.0,5,16,11,0.3125
Kai Jones,2022.0,1,2,1,0.5
Kai Jones,2023.0,4,19,15,0.21052631578947367
Kaiser Gates,2024.0,0,2,2,0.0
Kalin Lucas,2019.0,0,1,1,0.0
Kaniel Dickens,2005.0,3,9,6,0.3333333333333333
Kareem Rush,2004.0,68,187,119,0.36363636363636365
Kareem Rush,2005.0,51,137,86,0.3722627737226277
Kareem Rush,2006.0,57,164,107,0.3475609756097561
Kareem Rush,2008.0,102,262,160,0.3893129770992366
Kareem Rush,2009.0,10,33,23,0.30303030303030304
Kareem Rush,2010.0,1,3,2,0.3333333333333333
Karim Mane,2021.0,1,2,1,0.5
Karl Malone,2004.0,0,2,2,0.0
Karl-Anthony Towns,2016.0,30,88,58,0.3409090909090909
Karl-Anthony Towns,2017.0,101,276,175,0.36594202898550726
Karl-Anthony Towns,2018.0,123,296,173,0.4155405405405405
Karl-Anthony Towns,2019.0,142,355,213,0.4
Karl-Anthony Towns,2020.0,114,277,163,0.41155234657039713
Karl-Anthony Towns,2021.0,122,315,193,0.3873015873015873
Karl-Anthony Towns,2022.0,160,389,229,0.41131105398457585
Karl-Anthony Towns,2023.0,66,188,122,0.35106382978723405
Karl-Anthony Towns,2024.0,98,225,127,0.43555555555555553
Kasib Powell,2008.0,8,33,25,0.24242424242424243
Kawhi Leonard,2012.0,59,149,90,0.3959731543624161
Kawhi Leonard,2013.0,88,233,145,0.3776824034334764
Kawhi Leonard,2014.0,100,256,156,0.390625
Kawhi Leonard,2015.0,78,218,140,0.3577981651376147
Kawhi Leonard,2016.0,146,330,184,0.44242424242424244
Kawhi Leonard,2017.0,172,441,269,0.3900226757369615
Kawhi Leonard,2018.0,11,35,24,0.3142857142857143
Kawhi Leonard,2019.0,167,447,280,0.37360178970917224
Kawhi Leonard,2020.0,147,398,251,0.3693467336683417
Kawhi Leonard,2021.0,125,315,190,0.3968253968253968
Kawhi Leonard,2023.0,110,260,150,0.4230769230769231
Kawhi Leonard,2024.0,90,201,111,0.44776119402985076
Kay Felder,2017.0,7,22,15,0.3181818181818182
Kay Felder,2018.0,4,19,15,0.21052631578947367
Kedrick Brown,2004.0,37,97,60,0.38144329896907214
Kedrick Brown,2005.0,0,3,3,0.0
Keegan Murray,2023.0,218,533,315,0.4090056285178236
Keegan Murray,2024.0,95,262,167,0.36259541984732824
Keifer Sykes,2022.0,27,90,63,0.3
Keita Bates-Diop,2019.0,13,52,39,0.25
Keita Bates-Diop,2020.0,34,103,69,0.3300970873786408
Keita Bates-Diop,2021.0,5,17,12,0.29411764705882354
Keita Bates-Diop,2022.0,17,55,38,0.3090909090909091
Keita Bates-Diop,2023.0,56,142,86,0.39436619718309857
Keita Bates-Diop,2024.0,16,58,42,0.27586206896551724
Keith Appling,2016.0,0,3,3,0.0
Keith Bogans,2004.0,67,187,120,0.3582887700534759
Keith Bogans,2005.0,57,173,116,0.32947976878612717
Keith Bogans,2006.0,65,200,135,0.325
Keith Bogans,2007.0,53,137,84,0.38686131386861317
Keith Bogans,2008.0,163,454,291,0.3590308370044053
Keith Bogans,2009.0,74,218,144,0.3394495412844037
Keith Bogans,2010.0,71,202,131,0.35148514851485146
Keith Bogans,2011.0,115,296,181,0.3885135135135135
Keith Bogans,2012.0,3,12,9,0.25
Keith Bogans,2013.0,84,246,162,0.34146341463414637
Keith Bogans,2014.0,3,6,3,0.5
Keith McLeod,2004.0,1,10,9,0.1
Keith McLeod,2005.0,18,72,54,0.25
Keith McLeod,2006.0,24,82,58,0.2926829268292683
Keith McLeod,2007.0,16,45,29,0.35555555555555557
Keith Van Horn,2004.0,97,244,147,0.3975409836065574
Keith Van Horn,2005.0,54,146,92,0.3698630136986301
Keith Van Horn,2006.0,58,164,106,0.35365853658536583
Kelan Martin,2020.0,25,96,71,0.2604166666666667
Kelan Martin,2021.0,29,72,43,0.4027777777777778
Kelan Martin,2022.0,22,75,53,0.29333333333333333
Keldon Johnson,2020.0,13,22,9,0.5909090909090909
Keldon Johnson,2021.0,61,183,122,0.3333333333333333
Keldon Johnson,2022.0,159,404,245,0.3935643564356436
Keldon Johnson,2023.0,134,407,273,0.32923832923832924
Keldon Johnson,2024.0,77,229,152,0.33624454148471616
Kelenna Azubuike,2007.0,34,80,46,0.425
Kelenna Azubuike,2008.0,71,195,124,0.3641025641025641
Kelenna Azubuike,2009.0,94,210,116,0.44761904761904764
Kelenna Azubuike,2010.0,10,27,17,0.37037037037037035
Kelenna Azubuike,2012.0,2,4,2,0.5
Keljin Blevins,2021.0,2,9,7,0.2222222222222222
Keljin Blevins,2022.0,21,72,51,0.2916666666666667
Kelly Olynyk,2014.0,40,114,74,0.3508771929824561
Kelly Olynyk,2015.0,64,181,117,0.35359116022099446
Kelly Olynyk,2016.0,85,213,128,0.39906103286384975
Kelly Olynyk,2017.0,83,239,156,0.3472803347280335
Kelly Olynyk,2018.0,114,299,185,0.38127090301003347
Kelly Olynyk,2019.0,113,319,206,0.3542319749216301
Kelly Olynyk,2020.0,112,283,171,0.3957597173144876
Kelly Olynyk,2021.0,126,367,241,0.34332425068119893
Kelly Olynyk,2022.0,40,119,79,0.33613445378151263
Kelly Olynyk,2023.0,93,236,143,0.3940677966101695
Kelly Olynyk,2024.0,34,79,45,0.43037974683544306
Kelly Oubre Jr.,2016.0,25,79,54,0.31645569620253167
Kelly Oubre Jr.,2017.0,65,218,153,0.2981651376146789
Kelly Oubre Jr.,2018.0,130,388,258,0.33505154639175255
Kelly Oubre Jr.,2019.0,108,338,230,0.31952662721893493
Kelly Oubre Jr.,2020.0,108,307,199,0.3517915309446254
Kelly Oubre Jr.,2021.0,90,285,195,0.3157894736842105
Kelly Oubre Jr.,2022.0,192,557,365,0.34470377019748655
Kelly Oubre Jr.,2023.0,108,339,231,0.3185840707964602
Kelly Oubre Jr.,2024.0,50,141,91,0.3546099290780142
Kemba Walker,2012.0,69,226,157,0.3053097345132743
Kemba Walker,2013.0,107,332,225,0.32228915662650603
Kemba Walker,2014.0,121,351,230,0.34472934472934474
Kemba Walker,2015.0,85,280,195,0.30357142857142855
Kemba Walker,2016.0,196,533,337,0.3677298311444653
Kemba Walker,2017.0,240,601,361,0.39933444259567386
Kemba Walker,2018.0,231,601,370,0.3843594009983361
Kemba Walker,2019.0,260,730,470,0.3561643835616438
Kemba Walker,2020.0,219,599,380,0.3656093489148581
Kemba Walker,2021.0,132,374,242,0.35294117647058826
Kemba Walker,2022.0,73,199,126,0.36683417085427134
Kemba Walker,2023.0,7,28,21,0.25
Kendall Brown,2023.0,0,1,1,0.0
Kendall Brown,2024.0,0,1,1,0.0
Kendall Gill,2004.0,9,38,29,0.23684210526315788
Kendall Gill,2005.0,3,9,6,0.3333333333333333
Kendall Marshall,2013.0,23,73,50,0.3150684931506849
Kendall Marshall,2014.0,71,178,107,0.398876404494382
Kendall Marshall,2015.0,18,46,28,0.391304347826087
Kendall Marshall,2016.0,16,49,33,0.32653061224489793
Kendrick Nunn,2020.0,149,434,285,0.3433179723502304
Kendrick Nunn,2021.0,127,338,211,0.3757396449704142
Kendrick Nunn,2023.0,79,223,144,0.3542600896860987
Kendrick Perkins,2006.0,0,2,2,0.0
Kendrick Perkins,2007.0,0,3,3,0.0
Kendrick Perkins,2008.0,0,2,2,0.0
Kendrick Perkins,2009.0,0,3,3,0.0
Kendrick Perkins,2010.0,0,4,4,0.0
Kendrick Perkins,2013.0,0,2,2,0.0
Kendrick Perkins,2014.0,0,1,1,0.0
Kendrick Perkins,2015.0,0,1,1,0.0
Kennedy Chandler,2023.0,2,15,13,0.13333333333333333
Kenneth Faried,2014.0,0,3,3,0.0
Kenneth Faried,2015.0,1,8,7,0.125
Kenneth Faried,2016.0,1,2,1,0.5
Kenneth Faried,2017.0,0,6,6,0.0
Kenneth Faried,2018.0,0,1,1,0.0
Kenneth Faried,2019.0,9,26,17,0.34615384615384615
Kenneth Lofton,2023.0,6,19,13,0.3157894736842105
Kenneth Lofton,2024.0,3,10,7,0.3
Kenny Anderson,2004.0,1,4,3,0.25
Kenny Anderson,2005.0,6,13,7,0.46153846153846156
Kenny Thomas,2004.0,1,5,4,0.2
Kenny Thomas,2005.0,1,5,4,0.2
Kenny Thomas,2006.0,0,1,1,0.0
Kenny Thomas,2007.0,0,1,1,0.0
Kenrich Williams,2019.0,52,156,104,0.3333333333333333
Kenrich Williams,2020.0,25,97,72,0.25773195876288657
Kenrich Williams,2021.0,52,117,65,0.4444444444444444
Kenrich Williams,2022.0,41,121,80,0.33884297520661155
Kenrich Williams,2023.0,50,134,84,0.373134328358209
Kenrich Williams,2024.0,27,70,43,0.38571428571428573
Kent Bazemore,2013.0,10,35,25,0.2857142857142857
Kent Bazemore,2014.0,43,128,85,0.3359375
Kent Bazemore,2015.0,54,160,106,0.3375
Kent Bazemore,2016.0,125,366,241,0.34153005464480873
Kent Bazemore,2017.0,99,291,192,0.3402061855670103
Kent Bazemore,2018.0,108,274,166,0.39416058394160586
Kent Bazemore,2019.0,96,300,204,0.32
Kent Bazemore,2020.0,84,244,160,0.3442622950819672
Kent Bazemore,2021.0,79,194,115,0.4072164948453608
Kent Bazemore,2022.0,29,80,51,0.3625
Kentavious Caldwell-Pope,2014.0,59,185,126,0.31891891891891894
Kentavious Caldwell-Pope,2015.0,153,444,291,0.34459459459459457
Kentavious Caldwell-Pope,2016.0,126,396,270,0.3181818181818182
Kentavious Caldwell-Pope,2017.0,153,437,284,0.3501144164759725
Kentavious Caldwell-Pope,2018.0,159,414,255,0.38405797101449274
Kentavious Caldwell-Pope,2019.0,151,436,285,0.3463302752293578
Kentavious Caldwell-Pope,2020.0,137,358,221,0.38268156424581007
Kentavious Caldwell-Pope,2021.0,126,316,190,0.3987341772151899
Kentavious Caldwell-Pope,2022.0,159,408,249,0.3897058823529412
Kentavious Caldwell-Pope,2023.0,170,411,241,0.41362530413625304
Kentavious Caldwell-Pope,2024.0,66,170,104,0.38823529411764707
Kenyon Martin,2004.0,7,29,22,0.2413793103448276
Kenyon Martin,2005.0,0,13,13,0.0
Kenyon Martin,2006.0,5,22,17,0.22727272727272727
Kenyon Martin,2007.0,0,1,1,0.0
Kenyon Martin,2008.0,2,11,9,0.18181818181818182
Kenyon Martin,2009.0,15,43,28,0.3488372093023256
Kenyon Martin,2010.0,8,30,22,0.26666666666666666
Kenyon Martin,2011.0,2,9,7,0.2222222222222222
Kenyon Martin,2012.0,3,13,10,0.23076923076923078
Kenyon Martin,2014.0,0,1,1,0.0
Kenyon Martin Jr,2024.0,2,12,10,0.16666666666666666
Kenyon Martin Jr.,2021.0,35,96,61,0.3645833333333333
Kenyon Martin Jr.,2022.0,60,167,107,0.3592814371257485
Kenyon Martin Jr.,2023.0,68,216,148,0.3148148148148148
Kenyon Martin Jr.,2024.0,1,10,9,0.1
Keon Ellis,2023.0,6,12,6,0.5
Keon Ellis,2024.0,26,68,42,0.38235294117647056
Keon Johnson,2022.0,34,100,66,0.34
Keon Johnson,2023.0,28,81,53,0.345679012345679
Keon Johnson,2024.0,2,4,2,0.5
Kerry Kittles,2004.0,114,328,214,0.3475609756097561
Kerry Kittles,2005.0,7,21,14,0.3333333333333333
Kessler Edwards,2022.0,48,136,88,0.35294117647058826
Kessler Edwards,2023.0,17,55,38,0.3090909090909091
Kessler Edwards,2024.0,9,26,17,0.34615384615384615
Kevin Burleson,2006.0,10,53,43,0.18867924528301888
Kevin Durant,2008.0,59,205,146,0.28780487804878047
Kevin Durant,2009.0,97,230,133,0.4217391304347826
Kevin Durant,2010.0,138,386,248,0.35751295336787564
Kevin Durant,2011.0,182,523,341,0.3479923518164436
Kevin Durant,2012.0,174,454,280,0.3832599118942731
Kevin Durant,2013.0,161,404,243,0.39851485148514854
Kevin Durant,2014.0,235,616,381,0.3814935064935065
Kevin Durant,2015.0,64,159,95,0.4025157232704403
Kevin Durant,2016.0,217,592,375,0.36655405405405406
Kevin Durant,2017.0,155,398,243,0.38944723618090454
Kevin Durant,2018.0,220,551,331,0.3992740471869328
Kevin Durant,2019.0,172,468,296,0.36752136752136755
Kevin Durant,2021.0,118,271,153,0.4354243542435424
Kevin Durant,2022.0,122,321,199,0.38006230529595014
Kevin Durant,2023.0,110,281,171,0.3914590747330961
Kevin Durant,2024.0,88,194,106,0.4536082474226804
Kevin Garnett,2004.0,16,59,43,0.2711864406779661
Kevin Garnett,2005.0,6,25,19,0.24
Kevin Garnett,2006.0,8,30,22,0.26666666666666666
Kevin Garnett,2007.0,12,56,44,0.21428571428571427
Kevin Garnett,2008.0,2,19,17,0.10526315789473684
Kevin Garnett,2009.0,2,8,6,0.25
Kevin Garnett,2010.0,1,7,6,0.14285714285714285
Kevin Garnett,2011.0,1,6,5,0.16666666666666666
Kevin Garnett,2012.0,4,13,9,0.3076923076923077
Kevin Garnett,2013.0,2,18,16,0.1111111111111111
Kevin Garnett,2014.0,0,5,5,0.0
Kevin Garnett,2015.0,1,7,6,0.14285714285714285
Kevin Garnett,2016.0,0,1,1,0.0
Kevin Hervey,2020.0,3,20,17,0.15
Kevin Huerter,2019.0,136,354,218,0.384180790960452
Kevin Huerter,2020.0,127,334,207,0.38023952095808383
Kevin Huerter,2021.0,173,481,308,0.3596673596673597
Kevin Huerter,2022.0,173,449,276,0.38530066815144765
Kevin Huerter,2023.0,213,549,336,0.3879781420765027
Kevin Huerter,2024.0,85,233,148,0.3648068669527897
Kevin Knox,2019.0,125,364,239,0.3434065934065934
Kevin Knox,2020.0,65,199,134,0.32663316582914576
Kevin Knox,2021.0,35,89,54,0.39325842696629215
Kevin Knox,2022.0,21,64,43,0.328125
Kevin Knox,2023.0,65,186,121,0.34946236559139787
Kevin Knox,2024.0,30,87,57,0.3448275862068966
Kevin Love,2009.0,2,19,17,0.10526315789473684
Kevin Love,2010.0,35,106,71,0.330188679245283
Kevin Love,2011.0,88,211,123,0.41706161137440756
Kevin Love,2012.0,105,282,177,0.3723404255319149
Kevin Love,2013.0,20,92,72,0.21739130434782608
Kevin Love,2014.0,190,505,315,0.37623762376237624
Kevin Love,2015.0,153,413,260,0.3704600484261501
Kevin Love,2016.0,204,550,346,0.3709090909090909
Kevin Love,2017.0,195,500,305,0.39
Kevin Love,2018.0,173,435,262,0.39770114942528734
Kevin Love,2019.0,53,147,94,0.36054421768707484
Kevin Love,2020.0,146,391,245,0.3734015345268542
Kevin Love,2021.0,57,156,99,0.36538461538461536
Kevin Love,2022.0,188,479,291,0.3924843423799583
Kevin Love,2023.0,132,384,252,0.34375
Kevin Love,2024.0,54,160,106,0.3375
Kevin Martin,2005.0,5,25,20,0.2
Kevin Martin,2006.0,72,198,126,0.36363636363636365
Kevin Martin,2007.0,127,333,206,0.3813813813813814
Kevin Martin,2008.0,107,266,159,0.40225563909774437
Kevin Martin,2009.0,115,277,162,0.4151624548736462
Kevin Martin,2010.0,70,210,140,0.3333333333333333
Kevin Martin,2011.0,176,459,283,0.38344226579520696
Kevin Martin,2012.0,78,225,147,0.3466666666666667
Kevin Martin,2013.0,175,417,242,0.4196642685851319
Kevin Martin,2014.0,115,297,182,0.3872053872053872
Kevin Martin,2015.0,75,191,116,0.39267015706806285
Kevin Martin,2016.0,53,144,91,0.3680555555555556
Kevin Murphy,2013.0,1,5,4,0.2
Kevin Ollie,2004.0,4,9,5,0.4444444444444444
Kevin Ollie,2006.0,1,3,2,0.3333333333333333
Kevin Ollie,2007.0,0,2,2,0.0
Kevin Ollie,2008.0,0,1,1,0.0
Kevin Ollie,2009.0,0,1,1,0.0
Kevin Ollie,2010.0,0,1,1,0.0
Kevin Pangos,2022.0,6,26,20,0.23076923076923078
Kevin Porter Jr.,2020.0,53,158,105,0.33544303797468356
Kevin Porter Jr.,2021.0,50,161,111,0.3105590062111801
Kevin Porter Jr.,2022.0,155,413,258,0.37530266343825663
Kevin Porter Jr.,2023.0,141,385,244,0.36623376623376624
Kevin Seraphin,2012.0,0,1,1,0.0
Kevin Seraphin,2015.0,0,2,2,0.0
Kevin Seraphin,2016.0,0,2,2,0.0
Kevin Seraphin,2017.0,0,2,2,0.0
Kevin Willis,2004.0,0,2,2,0.0
Kevin Willis,2005.0,0,2,2,0.0
Kevinn Pinkney,2007.0,1,2,1,0.5
Kevon Harris,2023.0,16,43,27,0.37209302325581395
Kevon Looney,2016.0,1,2,1,0.5
Kevon Looney,2017.0,2,9,7,0.2222222222222222
Kevon Looney,2018.0,1,7,6,0.14285714285714285
Kevon Looney,2019.0,1,10,9,0.1
Kevon Looney,2020.0,1,14,13,0.07142857142857142
Kevon Looney,2021.0,4,17,13,0.23529411764705882
Kevon Looney,2022.0,0,1,1,0.0
Kevon Looney,2023.0,0,1,1,0.0
Kevon Looney,2024.0,0,1,1,0.0
Keyon Dooling,2004.0,8,46,38,0.17391304347826086
Keyon Dooling,2005.0,26,94,68,0.2765957446808511
Keyon Dooling,2006.0,13,43,30,0.3023255813953488
Keyon Dooling,2007.0,32,99,67,0.32323232323232326
Keyon Dooling,2008.0,31,88,57,0.3522727272727273
Keyon Dooling,2009.0,99,235,136,0.42127659574468085
Keyon Dooling,2010.0,59,157,98,0.37579617834394907
Keyon Dooling,2011.0,81,234,153,0.34615384615384615
Keyon Dooling,2012.0,38,109,71,0.3486238532110092
Keyon Dooling,2013.0,10,25,15,0.4
Keyontae Johnson,2024.0,2,11,9,0.18181818181818182
Keyonte George,2024.0,57,177,120,0.3220338983050847
Khem Birch,2019.0,0,1,1,0.0
Khem Birch,2020.0,0,1,1,0.0
Khem Birch,2021.0,13,52,39,0.25
Khem Birch,2022.0,2,18,16,0.1111111111111111
Khem Birch,2023.0,1,2,1,0.5
Khris Middleton,2013.0,14,44,30,0.3181818181818182
Khris Middleton,2014.0,120,290,170,0.41379310344827586
Khris Middleton,2015.0,120,302,182,0.3973509933774834
Khris Middleton,2016.0,143,361,218,0.3961218836565097
Khris Middleton,2017.0,51,121,70,0.4214876033057851
Khris Middleton,2018.0,171,448,277,0.38169642857142855
Khris Middleton,2019.0,219,566,347,0.3869257950530035
Khris Middleton,2020.0,170,419,249,0.40572792362768495
Khris Middleton,2021.0,211,540,329,0.3907407407407407
Khris Middleton,2022.0,168,448,280,0.375
Khris Middleton,2023.0,64,194,130,0.32989690721649484
Khris Middleton,2024.0,66,177,111,0.3728813559322034
Khyri Thomas,2019.0,11,39,28,0.28205128205128205
Khyri Thomas,2020.0,5,14,9,0.35714285714285715
Khyri Thomas,2021.0,9,27,18,0.3333333333333333
Killian Hayes,2021.0,20,72,52,0.2777777777777778
Killian Hayes,2022.0,44,167,123,0.2634730538922156
Killian Hayes,2023.0,80,286,206,0.27972027972027974
Killian Hayes,2024.0,20,70,50,0.2857142857142857
Killian Tillie,2021.0,10,33,23,0.30303030303030304
Killian Tillie,2022.0,27,86,59,0.313953488372093
Kim English,2013.0,14,50,36,0.28
Kira Lewis,2021.0,40,120,80,0.3333333333333333
Kira Lewis,2022.0,13,58,45,0.22413793103448276
Kira Lewis,2023.0,15,34,19,0.4411764705882353
Kira Lewis,2024.0,2,20,18,0.1
Kirk Hinrich,2004.0,144,369,225,0.3902439024390244
Kirk Hinrich,2005.0,162,441,279,0.3673469387755102
Kirk Hinrich,2006.0,133,363,230,0.36639118457300274
Kirk Hinrich,2007.0,153,380,227,0.4026315789473684
Kirk Hinrich,2008.0,84,240,156,0.35
Kirk Hinrich,2009.0,82,199,117,0.4120603015075377
Kirk Hinrich,2010.0,112,296,184,0.3783783783783784
Kirk Hinrich,2011.0,83,207,124,0.40096618357487923
Kirk Hinrich,2012.0,53,152,99,0.34868421052631576
Kirk Hinrich,2013.0,75,193,118,0.38860103626943004
Kirk Hinrich,2014.0,92,261,169,0.3524904214559387
Kirk Hinrich,2015.0,64,178,114,0.3595505617977528
Kirk Hinrich,2016.0,25,65,40,0.38461538461538464
Kirk Penney,2004.0,1,3,2,0.3333333333333333
Kirk Penney,2005.0,0,1,1,0.0
Kirk Snyder,2005.0,30,85,55,0.35294117647058826
Kirk Snyder,2006.0,46,129,83,0.35658914728682173
Kirk Snyder,2007.0,11,46,35,0.2391304347826087
Kirk Snyder,2008.0,5,23,18,0.21739130434782608
Klay Thompson,2012.0,111,268,157,0.4141791044776119
Klay Thompson,2013.0,236,585,349,0.40341880341880343
Klay Thompson,2014.0,239,579,340,0.41278065630397237
Klay Thompson,2015.0,296,691,395,0.4283646888567294
Klay Thompson,2016.0,374,881,507,0.4245175936435868
Klay Thompson,2017.0,309,753,444,0.4103585657370518
Klay Thompson,2018.0,296,678,382,0.4365781710914454
Klay Thompson,2019.0,311,757,446,0.4108322324966975
Klay Thompson,2022.0,191,496,305,0.3850806451612903
Klay Thompson,2023.0,351,867,516,0.40484429065743943
Klay Thompson,2024.0,143,370,227,0.3864864864864865
Kobe Brown,2024.0,8,30,22,0.26666666666666666
Kobe Bryant,2004.0,95,314,219,0.30254777070063693
Kobe Bryant,2005.0,131,387,256,0.3385012919896641
Kobe Bryant,2006.0,194,553,359,0.3508137432188065
Kobe Bryant,2007.0,147,426,279,0.34507042253521125
Kobe Bryant,2008.0,182,521,339,0.3493282149712092
Kobe Bryant,2009.0,155,442,287,0.3506787330316742
Kobe Bryant,2010.0,148,432,284,0.3425925925925926
Kobe Bryant,2011.0,127,397,270,0.3198992443324937
Kobe Bryant,2012.0,104,347,243,0.29971181556195964
Kobe Bryant,2013.0,132,407,275,0.32432432432432434
Kobe Bryant,2014.0,3,16,13,0.1875
Kobe Bryant,2015.0,54,184,130,0.29347826086956524
Kobe Bryant,2016.0,133,467,334,0.284796573875803
Kobe Bufkin,2024.0,0,1,1,0.0
Kobi Simmons,2018.0,11,39,28,0.28205128205128205
Kobi Simmons,2023.0,1,5,4,0.2
Kosta Koufos,2011.0,0,2,2,0.0
Kosta Koufos,2013.0,1,2,1,0.5
Kosta Koufos,2017.0,0,1,1,0.0
Kostas Papanikolaou,2015.0,31,109,78,0.28440366972477066
Kostas Papanikolaou,2016.0,10,32,22,0.3125
Kris Dunn,2017.0,21,73,52,0.2876712328767123
Kris Dunn,2018.0,43,134,91,0.3208955223880597
Kris Dunn,2019.0,34,96,62,0.3541666666666667
Kris Dunn,2020.0,29,112,83,0.25892857142857145
Kris Dunn,2021.0,0,3,3,0.0
Kris Dunn,2022.0,1,11,10,0.09090909090909091
Kris Dunn,2023.0,17,36,19,0.4722222222222222
Kris Dunn,2024.0,21,54,33,0.3888888888888889
Kris Humphries,2005.0,2,6,4,0.3333333333333333
Kris Humphries,2006.0,0,5,5,0.0
Kris Humphries,2008.0,0,2,2,0.0
Kris Humphries,2010.0,0,1,1,0.0
Kris Humphries,2011.0,0,1,1,0.0
Kris Humphries,2013.0,0,2,2,0.0
Kris Humphries,2014.0,0,2,2,0.0
Kris Humphries,2015.0,0,7,7,0.0
Kris Humphries,2016.0,39,118,79,0.3305084745762712
Kris Humphries,2017.0,19,54,35,0.35185185185185186
Kris Joseph,2013.0,0,3,3,0.0
Kris Murray,2024.0,15,50,35,0.3
Kristaps Porzingis,2016.0,81,243,162,0.3333333333333333
Kristaps Porzingis,2017.0,112,313,201,0.35782747603833864
Kristaps Porzingis,2018.0,90,229,139,0.3930131004366812
Kristaps Porzingis,2020.0,151,420,269,0.3595238095238095
Kristaps Porzingis,2021.0,105,285,180,0.3684210526315789
Kristaps Porzingis,2022.0,78,252,174,0.30952380952380953
Kristaps Porzingis,2023.0,137,356,219,0.3848314606741573
Kristaps Porzingis,2024.0,60,167,107,0.3592814371257485
Kurt Thomas,2004.0,0,3,3,0.0
Kurt Thomas,2005.0,2,4,2,0.5
Kurt Thomas,2007.0,0,1,1,0.0
Kurt Thomas,2008.0,0,1,1,0.0
Kurt Thomas,2009.0,0,2,2,0.0
Kurt Thomas,2011.0,1,3,2,0.3333333333333333
Kurt Thomas,2013.0,1,1,0,1.0
Kwame Brown,2004.0,1,2,1,0.5
Kwame Brown,2006.0,0,1,1,0.0
Kwame Brown,2007.0,0,1,1,0.0
Kwame Brown,2010.0,0,1,1,0.0
Ky Bowman,2020.0,33,107,74,0.308411214953271
Kyle Anderson,2015.0,3,11,8,0.2727272727272727
Kyle Anderson,2016.0,13,40,27,0.325
Kyle Anderson,2017.0,18,50,32,0.36
Kyle Anderson,2018.0,19,61,42,0.3114754098360656
Kyle Anderson,2019.0,9,34,25,0.2647058823529412
Kyle Anderson,2020.0,25,86,61,0.29069767441860467
Kyle Anderson,2021.0,99,276,177,0.358695652173913
Kyle Anderson,2022.0,39,121,82,0.32231404958677684
Kyle Anderson,2023.0,45,111,66,0.40540540540540543
Kyle Anderson,2024.0,5,29,24,0.1724137931034483
Kyle Collinsworth,2018.0,4,17,13,0.23529411764705882
Kyle Guy,2020.0,0,3,3,0.0
Kyle Guy,2021.0,13,46,33,0.2826086956521739
Kyle Guy,2022.0,14,40,26,0.35
Kyle Korver,2004.0,81,205,124,0.3951219512195122
Kyle Korver,2005.0,233,582,349,0.40034364261168387
Kyle Korver,2006.0,184,438,254,0.4200913242009132
Kyle Korver,2007.0,132,307,175,0.42996742671009774
Kyle Korver,2008.0,119,331,212,0.3595166163141994
Kyle Korver,2009.0,115,293,178,0.3924914675767918
Kyle Korver,2010.0,70,133,63,0.5263157894736842
Kyle Korver,2011.0,142,341,199,0.41642228739002934
Kyle Korver,2012.0,122,284,162,0.4295774647887324
Kyle Korver,2013.0,201,448,247,0.4486607142857143
Kyle Korver,2014.0,208,446,238,0.4663677130044843
Kyle Korver,2015.0,260,559,299,0.46511627906976744
Kyle Korver,2016.0,182,451,269,0.4035476718403548
Kyle Korver,2017.0,189,427,238,0.4426229508196721
Kyle Korver,2018.0,209,485,276,0.4309278350515464
Kyle Korver,2019.0,140,354,214,0.3954802259887006
Kyle Korver,2020.0,114,274,160,0.41605839416058393
Kyle Kuzma,2018.0,159,435,276,0.36551724137931035
Kyle Kuzma,2019.0,128,422,294,0.3033175355450237
Kyle Kuzma,2020.0,112,355,243,0.3154929577464789
Kyle Kuzma,2021.0,141,405,264,0.34814814814814815
Kyle Kuzma,2022.0,128,375,247,0.3413333333333333
Kyle Kuzma,2023.0,160,481,321,0.33264033264033266
Kyle Kuzma,2024.0,103,309,206,0.3333333333333333
Kyle Lowry,2007.0,3,8,5,0.375
Kyle Lowry,2008.0,36,140,104,0.2571428571428571
Kyle Lowry,2009.0,29,114,85,0.2543859649122807
Kyle Lowry,2010.0,37,136,99,0.27205882352941174
Kyle Lowry,2011.0,129,343,214,0.3760932944606414
Kyle Lowry,2012.0,79,211,132,0.3744075829383886
Kyle Lowry,2013.0,101,279,178,0.36200716845878134
Kyle Lowry,2014.0,207,543,336,0.3812154696132597
Kyle Lowry,2015.0,137,414,277,0.3309178743961353
Kyle Lowry,2016.0,254,685,431,0.3708029197080292
Kyle Lowry,2017.0,206,504,298,0.4087301587301587
Kyle Lowry,2018.0,266,659,393,0.40364188163884673
Kyle Lowry,2019.0,209,598,389,0.3494983277591973
Kyle Lowry,2020.0,187,538,351,0.3475836431226766
Kyle Lowry,2021.0,131,331,200,0.3957703927492447
Kyle Lowry,2022.0,157,436,279,0.36009174311926606
Kyle Lowry,2023.0,140,398,258,0.35175879396984927
Kyle Lowry,2024.0,62,161,99,0.38509316770186336
Kyle O'Quinn,2013.0,0,1,1,0.0
Kyle O'Quinn,2014.0,0,3,3,0.0
Kyle O'Quinn,2015.0,12,43,31,0.27906976744186046
Kyle O'Quinn,2016.0,5,22,17,0.22727272727272727
Kyle O'Quinn,2017.0,2,17,15,0.11764705882352941
Kyle O'Quinn,2018.0,4,17,13,0.23529411764705882
Kyle O'Quinn,2019.0,1,12,11,0.08333333333333333
Kyle O'Quinn,2020.0,7,27,20,0.25925925925925924
Kyle Singler,2013.0,70,198,128,0.35353535353535354
Kyle Singler,2014.0,94,246,152,0.3821138211382114
Kyle Singler,2015.0,96,241,145,0.3983402489626556
Kyle Singler,2016.0,32,101,69,0.31683168316831684
Kyle Singler,2017.0,7,37,30,0.1891891891891892
Kyle Singler,2018.0,2,5,3,0.4
Kyle Weaver,2009.0,32,93,61,0.34408602150537637
Kyle Weaver,2010.0,7,20,13,0.35
Kyle Weaver,2011.0,3,7,4,0.42857142857142855
Kyle Wiltjer,2017.0,5,14,9,0.35714285714285715
Kyrie Irving,2012.0,73,183,110,0.3989071038251366
Kyrie Irving,2013.0,109,279,170,0.3906810035842294
Kyrie Irving,2014.0,123,344,221,0.35755813953488375
Kyrie Irving,2015.0,184,438,254,0.4200913242009132
Kyrie Irving,2016.0,135,378,243,0.35714285714285715
Kyrie Irving,2017.0,221,559,338,0.3953488372093023
Kyrie Irving,2018.0,166,407,241,0.40786240786240785
Kyrie Irving,2019.0,192,492,300,0.3902439024390244
Kyrie Irving,2020.0,56,142,86,0.39436619718309857
Kyrie Irving,2021.0,176,443,267,0.3972911963882618
Kyrie Irving,2022.0,108,260,152,0.4153846153846154
Kyrie Irving,2023.0,188,496,308,0.3790322580645161
Kyrie Irving,2024.0,78,190,112,0.4105263157894737
Kyrylo Fesenko,2010.0,0,1,1,0.0
Kyrylo Fesenko,2011.0,0,1,1,0.0
LaMarcus Aldridge,2007.0,0,2,2,0.0
LaMarcus Aldridge,2008.0,1,7,6,0.14285714285714285
LaMarcus Aldridge,2009.0,8,32,24,0.25
LaMarcus Aldridge,2010.0,6,18,12,0.3333333333333333
LaMarcus Aldridge,2011.0,4,23,19,0.17391304347826086
LaMarcus Aldridge,2012.0,2,11,9,0.18181818181818182
LaMarcus Aldridge,2013.0,2,14,12,0.14285714285714285
LaMarcus Aldridge,2014.0,5,18,13,0.2777777777777778
LaMarcus Aldridge,2015.0,40,116,76,0.3448275862068966
LaMarcus Aldridge,2016.0,2,18,16,0.1111111111111111
LaMarcus Aldridge,2017.0,25,70,45,0.35714285714285715
LaMarcus Aldridge,2018.0,30,97,67,0.30927835051546393
LaMarcus Aldridge,2019.0,13,53,40,0.24528301886792453
LaMarcus Aldridge,2020.0,61,157,96,0.3885350318471338
LaMarcus Aldridge,2021.0,31,80,49,0.3875
LaMarcus Aldridge,2022.0,14,46,32,0.30434782608695654
LaMelo Ball,2021.0,95,268,173,0.35447761194029853
LaMelo Ball,2022.0,224,579,355,0.38687392055267705
LaMelo Ball,2023.0,144,383,239,0.37597911227154046
LaMelo Ball,2024.0,70,197,127,0.3553299492385787
Lamar Odom,2004.0,69,231,162,0.2987012987012987
Lamar Odom,2005.0,36,117,81,0.3076923076923077
Lamar Odom,2006.0,86,245,159,0.3510204081632653
Lamar Odom,2007.0,57,193,136,0.29533678756476683
Lamar Odom,2008.0,34,124,90,0.27419354838709675
Lamar Odom,2009.0,51,138,87,0.3695652173913043
Lamar Odom,2010.0,68,223,155,0.30493273542600896
Lamar Odom,2011.0,72,198,126,0.36363636363636365
Lamar Odom,2012.0,28,111,83,0.25225225225225223
Lamar Odom,2013.0,23,104,81,0.22115384615384615
Lamar Patterson,2016.0,13,52,39,0.25
Lamar Patterson,2017.0,1,6,5,0.16666666666666666
Lamar Stevens,2021.0,4,25,21,0.16
Lamar Stevens,2022.0,18,65,47,0.27692307692307694
Lamar Stevens,2023.0,31,96,65,0.3229166666666667
Lamar Stevens,2024.0,2,7,5,0.2857142857142857
Lamond Murray,2004.0,21,60,39,0.35
Lamond Murray,2005.0,46,105,59,0.4380952380952381
Lamond Murray,2006.0,39,112,73,0.3482142857142857
Lance Stephenson,2011.0,0,5,5,0.0
Lance Stephenson,2012.0,5,32,27,0.15625
Lance Stephenson,2013.0,80,252,172,0.31746031746031744
Lance Stephenson,2014.0,110,311,201,0.3536977491961415
Lance Stephenson,2015.0,18,105,87,0.17142857142857143
Lance Stephenson,2016.0,32,83,51,0.3855421686746988
Lance Stephenson,2017.0,13,38,25,0.34210526315789475
Lance Stephenson,2018.0,75,258,183,0.29069767441860467
Lance Stephenson,2019.0,73,197,124,0.37055837563451777
Lance Stephenson,2022.0,27,90,63,0.3
Lance Thomas,2012.0,0,1,1,0.0
Lance Thomas,2015.0,7,22,15,0.3181818181818182
Lance Thomas,2016.0,44,109,65,0.4036697247706422
Lance Thomas,2017.0,38,85,47,0.4470588235294118
Lance Thomas,2018.0,50,124,74,0.4032258064516129
Lance Thomas,2019.0,22,79,57,0.27848101265822783
Lance Thomas,2020.0,4,15,11,0.26666666666666666
Landry Fields,2011.0,86,223,137,0.38565022421524664
Landry Fields,2012.0,32,126,94,0.25396825396825395
Landry Fields,2013.0,2,14,12,0.14285714285714285
Landry Fields,2014.0,0,5,5,0.0
Landry Fields,2015.0,1,2,1,0.5
Landry Shamet,2019.0,177,427,250,0.41451990632318503
Landry Shamet,2020.0,126,338,212,0.3727810650887574
Landry Shamet,2021.0,139,360,221,0.3861111111111111
Landry Shamet,2022.0,132,360,228,0.36666666666666664
Landry Shamet,2023.0,86,228,142,0.37719298245614036
Landry Shamet,2024.0,37,98,61,0.37755102040816324
Langston Galloway,2015.0,62,176,114,0.3522727272727273
Langston Galloway,2016.0,77,224,147,0.34375
Langston Galloway,2017.0,120,307,187,0.39087947882736157
Langston Galloway,2018.0,75,218,143,0.3440366972477064
Langston Galloway,2019.0,144,406,262,0.35467980295566504
Langston Galloway,2020.0,132,331,199,0.3987915407854985
Langston Galloway,2021.0,36,87,51,0.41379310344827586
Langston Galloway,2022.0,2,16,14,0.125
Laron Profit,2005.0,8,28,20,0.2857142857142857
Laron Profit,2006.0,3,18,15,0.16666666666666666
Larry Drew II,2015.0,4,26,22,0.15384615384615385
Larry Drew II,2018.0,3,9,6,0.3333333333333333
Larry Hughes,2004.0,79,232,153,0.34051724137931033
Larry Hughes,2005.0,66,242,176,0.2727272727272727
Larry Hughes,2006.0,33,94,61,0.35106382978723405
Larry Hughes,2007.0,93,276,183,0.33695652173913043
Larry Hughes,2008.0,67,194,127,0.34536082474226804
Larry Hughes,2009.0,75,193,118,0.38860103626943004
Larry Hughes,2010.0,47,149,102,0.31543624161073824
Larry Hughes,2012.0,1,7,6,0.14285714285714285
Larry Nance,2016.0,1,10,9,0.1
Larry Nance,2017.0,10,36,26,0.2777777777777778
Larry Nance,2018.0,2,13,11,0.15384615384615385
Larry Nance,2019.0,33,98,65,0.336734693877551
Larry Nance,2020.0,56,159,103,0.3522012578616352
Larry Nance,2021.0,41,114,73,0.35964912280701755
Larry Nance,2022.0,25,79,54,0.31645569620253167
Larry Nance,2023.0,14,42,28,0.3333333333333333
Larry Nance,2024.0,17,35,18,0.4857142857142857
Larry Owens,2011.0,6,13,7,0.46153846153846156
Larry Owens,2012.0,2,5,3,0.4
Larry Sanders,2012.0,0,2,2,0.0
Larry Sanders,2013.0,0,2,2,0.0
Larry Sanders,2014.0,0,1,1,0.0
Latrell Sprewell,2004.0,136,395,259,0.34430379746835443
Latrell Sprewell,2005.0,69,211,142,0.32701421800947866
Lauri Markkanen,2018.0,145,401,256,0.36159600997506236
Lauri Markkanen,2019.0,120,332,212,0.3614457831325301
Lauri Markkanen,2020.0,109,317,208,0.3438485804416404
Lauri Markkanen,2021.0,119,296,177,0.40202702702702703
Lauri Markkanen,2022.0,142,392,250,0.3622448979591837
Lauri Markkanen,2023.0,200,511,311,0.3913894324853229
Lauri Markkanen,2024.0,121,301,180,0.4019933554817276
Lavoy Allen,2013.0,0,1,1,0.0
Lavoy Allen,2014.0,2,13,11,0.15384615384615385
Lavoy Allen,2017.0,0,1,1,0.0
Lawrence Roberts,2006.0,0,2,2,0.0
Lawrence Roberts,2007.0,0,2,2,0.0
Lazar Hayward,2011.0,17,60,43,0.2833333333333333
Lazar Hayward,2012.0,4,14,10,0.2857142857142857
Lazar Hayward,2013.0,0,4,4,0.0
LeBron James,2004.0,63,217,154,0.2903225806451613
LeBron James,2005.0,108,308,200,0.35064935064935066
LeBron James,2006.0,148,442,294,0.334841628959276
LeBron James,2007.0,120,385,265,0.3116883116883117
LeBron James,2008.0,131,429,298,0.30536130536130535
LeBron James,2009.0,159,465,306,0.3419354838709677
LeBron James,2010.0,149,437,288,0.34096109839816935
LeBron James,2011.0,122,364,242,0.33516483516483514
LeBron James,2012.0,76,234,158,0.3247863247863248
LeBron James,2013.0,139,350,211,0.39714285714285713
LeBron James,2014.0,151,392,241,0.3852040816326531
LeBron James,2015.0,145,449,304,0.32293986636971045
LeBron James,2016.0,119,376,257,0.31648936170212766
LeBron James,2017.0,168,449,281,0.3741648106904232
LeBron James,2018.0,188,520,332,0.36153846153846153
LeBron James,2019.0,111,327,216,0.3394495412844037
LeBron James,2020.0,192,544,352,0.35294117647058826
LeBron James,2021.0,124,337,213,0.36795252225519287
LeBron James,2022.0,161,448,287,0.359375
LeBron James,2023.0,149,483,334,0.3084886128364389
LeBron James,2024.0,91,229,138,0.39737991266375544
Leaky Black,2024.0,3,7,4,0.42857142857142855
Leandro Barbosa,2004.0,83,210,127,0.3952380952380952
Leandro Barbosa,2005.0,55,149,94,0.3691275167785235
Leandro Barbosa,2006.0,114,265,151,0.43018867924528303
Leandro Barbosa,2007.0,208,497,289,0.41851106639839036
Leandro Barbosa,2008.0,168,440,272,0.38181818181818183
Leandro Barbosa,2009.0,90,240,150,0.375
Leandro Barbosa,2010.0,56,171,115,0.32748538011695905
Leandro Barbosa,2011.0,72,213,141,0.3380281690140845
Leandro Barbosa,2012.0,68,190,122,0.35789473684210527
Leandro Barbosa,2013.0,18,47,29,0.3829787234042553
Leandro Barbosa,2014.0,7,25,18,0.28
Leandro Barbosa,2015.0,51,135,84,0.37777777777777777
Leandro Barbosa,2016.0,50,138,88,0.36231884057971014
Leandro Barbosa,2017.0,35,98,63,0.35714285714285715
Leandro Bolmaro,2022.0,5,18,13,0.2777777777777778
Leandro Bolmaro,2023.0,0,4,4,0.0
Lee Nailon,2004.0,0,3,3,0.0
Lee Nailon,2005.0,0,2,2,0.0
Leon Powe,2007.0,0,2,2,0.0
Leon Powe,2008.0,0,1,1,0.0
Leon Powe,2011.0,0,2,2,0.0
Leonard Miller,2024.0,20,58,38,0.3448275862068966
Lester Hudson,2010.0,5,16,11,0.3125
Lester Hudson,2011.0,4,15,11,0.26666666666666666
Lester Hudson,2012.0,16,64,48,0.25
Lester Hudson,2015.0,5,13,8,0.38461538461538464
Lester Quinones,2023.0,2,4,2,0.5
Lester Quinones,2024.0,5,13,8,0.38461538461538464
Linas Kleiza,2006.0,2,14,12,0.14285714285714285
Linas Kleiza,2007.0,84,227,143,0.3700440528634361
Linas Kleiza,2008.0,97,291,194,0.3333333333333333
Linas Kleiza,2009.0,104,307,203,0.33876221498371334
Linas Kleiza,2011.0,39,131,92,0.29770992366412213
Linas Kleiza,2012.0,62,179,117,0.3463687150837989
Linas Kleiza,2013.0,20,66,46,0.30303030303030304
Lindell Wigginton,2022.0,9,26,17,0.34615384615384615
Lindell Wigginton,2023.0,6,18,12,0.3333333333333333
Lindell Wigginton,2024.0,0,2,2,0.0
Lindsey Hunter,2004.0,21,80,59,0.2625
Lindsey Hunter,2005.0,31,120,89,0.25833333333333336
Lindsey Hunter,2006.0,25,87,62,0.28735632183908044
Lindsey Hunter,2007.0,42,137,95,0.30656934306569344
Lindsey Hunter,2008.0,12,37,25,0.32432432432432434
Lindsey Hunter,2009.0,17,51,34,0.3333333333333333
Lindsey Hunter,2010.0,1,13,12,0.07692307692307693
Lindy Waters III,2022.0,53,146,93,0.363013698630137
Lindy Waters III,2023.0,58,162,104,0.35802469135802467
Lindy Waters III,2024.0,15,37,22,0.40540540540540543
Linton Johnson,2004.0,7,33,26,0.21212121212121213
Linton Johnson,2005.0,0,1,1,0.0
Linton Johnson,2006.0,13,36,23,0.3611111111111111
Linton Johnson,2007.0,10,30,20,0.3333333333333333
Linton Johnson,2008.0,1,3,2,0.3333333333333333
Linton Johnson,2009.0,1,2,1,0.5
Lionel Chalmers,2005.0,12,49,37,0.24489795918367346
London Perrantes,2018.0,0,3,3,0.0
Lonnie Walker,2019.0,5,14,9,0.35714285714285715
Lonnie Walker,2020.0,41,101,60,0.40594059405940597
Lonnie Walker,2021.0,100,285,185,0.3508771929824561
Lonnie Walker,2022.0,113,357,244,0.3165266106442577
Lonnie Walker,2023.0,104,283,179,0.3674911660777385
Lonnie Walker,2024.0,57,129,72,0.4418604651162791
Lonny Baxter,2004.0,1,3,2,0.3333333333333333
Lonzo Ball,2018.0,90,295,205,0.3050847457627119
Lonzo Ball,2019.0,75,228,153,0.32894736842105265
Lonzo Ball,2020.0,148,395,247,0.37468354430379747
Lonzo Ball,2021.0,172,455,283,0.378021978021978
Lonzo Ball,2022.0,110,260,150,0.4230769230769231
Loren Woods,2005.0,0,1,1,0.0
Loren Woods,2006.0,0,1,1,0.0
Lorenzen Wright,2004.0,0,5,5,0.0
Lorenzen Wright,2005.0,0,3,3,0.0
Lorenzen Wright,2006.0,0,2,2,0.0
Lorenzo Brown,2014.0,3,30,27,0.1
Lorenzo Brown,2015.0,6,28,22,0.21428571428571427
Lorenzo Brown,2016.0,1,8,7,0.125
Lorenzo Brown,2018.0,4,17,13,0.23529411764705882
Lorenzo Brown,2019.0,6,28,22,0.21428571428571427
Lou Amundson,2009.0,0,1,1,0.0
Lou Amundson,2010.0,0,1,1,0.0
Lou Amundson,2015.0,0,1,1,0.0
Lou Williams,2006.0,2,9,7,0.2222222222222222
Lou Williams,2007.0,12,37,25,0.32432432432432434
Lou Williams,2008.0,57,160,103,0.35625
Lou Williams,2009.0,69,236,167,0.2923728813559322
Lou Williams,2010.0,70,206,136,0.33980582524271846
Lou Williams,2011.0,94,273,179,0.3443223443223443
Lou Williams,2012.0,91,277,186,0.3285198555956679
Lou Williams,2013.0,72,196,124,0.3673469387755102
Lou Williams,2014.0,84,247,163,0.340080971659919
Lou Williams,2015.0,156,468,312,0.3333333333333333
Lou Williams,2016.0,110,320,210,0.34375
Lou Williams,2017.0,174,483,309,0.36024844720496896
Lou Williams,2018.0,186,518,332,0.3590733590733591
Lou Williams,2019.0,111,310,199,0.3580645161290323
Lou Williams,2020.0,123,366,243,0.3360655737704918
Lou Williams,2021.0,82,203,121,0.4039408866995074
Lou Williams,2022.0,37,102,65,0.3627450980392157
Louis King,2020.0,4,11,7,0.36363636363636365
Louis King,2021.0,4,11,7,0.36363636363636365
Louis King,2022.0,8,27,19,0.2962962962962963
Louis King,2023.0,4,8,4,0.5
Luc Mbah a Moute,2009.0,0,4,4,0.0
Luc Mbah a Moute,2010.0,6,19,13,0.3157894736842105
Luc Mbah a Moute,2011.0,0,7,7,0.0
Luc Mbah a Moute,2012.0,1,4,3,0.25
Luc Mbah a Moute,2013.0,13,41,28,0.3170731707317073
Luc Mbah a Moute,2014.0,4,17,13,0.23529411764705882
Luc Mbah a Moute,2015.0,62,202,140,0.3069306930693069
Luc Mbah a Moute,2016.0,13,40,27,0.325
Luc Mbah a Moute,2017.0,48,126,78,0.38095238095238093
Luc Mbah a Moute,2018.0,66,188,122,0.35106382978723405
Luc Mbah a Moute,2019.0,2,6,4,0.3333333333333333
Luc Mbah a Moute,2020.0,0,2,2,0.0
Luca Vildoza,2022.0,1,5,4,0.2
Lucas Nogueira,2016.0,1,3,2,0.3333333333333333
Lucas Nogueira,2017.0,3,16,13,0.1875
Lucas Nogueira,2018.0,5,19,14,0.2631578947368421
Lucious Harris,2004.0,41,113,72,0.36283185840707965
Lucious Harris,2005.0,21,65,44,0.3230769230769231
Luguentz Dort,2020.0,43,151,108,0.2847682119205298
Luguentz Dort,2021.0,113,329,216,0.3434650455927052
Luguentz Dort,2022.0,130,391,261,0.33248081841432225
Luguentz Dort,2023.0,135,409,274,0.33007334963325186
Luguentz Dort,2024.0,82,204,122,0.4019607843137255
Luis Flores,2005.0,5,10,5,0.5
Luis Montero,2016.0,3,11,8,0.2727272727272727
Luis Scola,2008.0,0,4,4,0.0
Luis Scola,2009.0,0,3,3,0.0
Luis Scola,2010.0,1,5,4,0.2
Luis Scola,2011.0,0,3,3,0.0
Luis Scola,2012.0,0,3,3,0.0
Luis Scola,2013.0,3,16,13,0.1875
Luis Scola,2014.0,2,10,8,0.2
Luis Scola,2015.0,5,20,15,0.25
Luis Scola,2016.0,69,182,113,0.3791208791208791
Luis Scola,2017.0,17,50,33,0.34
Luka Doncic,2019.0,168,515,347,0.3262135922330097
Luka Doncic,2020.0,187,585,398,0.31965811965811963
Luka Doncic,2021.0,223,624,401,0.3573717948717949
Luka Doncic,2022.0,252,717,465,0.3514644351464435
Luka Doncic,2023.0,185,541,356,0.3419593345656192
Luka Doncic,2024.0,152,405,253,0.37530864197530867
Luka Garza,2022.0,16,49,33,0.32653061224489793
Luka Garza,2023.0,14,39,25,0.358974358974359
Luka Garza,2024.0,0,5,5,0.0
Luka Samanic,2020.0,3,8,5,0.375
Luka Samanic,2021.0,12,43,31,0.27906976744186046
Luka Samanic,2023.0,8,31,23,0.25806451612903225
Luka Samanic,2024.0,5,21,16,0.23809523809523808
Luke Babbitt,2011.0,3,16,13,0.1875
Luke Babbitt,2012.0,43,100,57,0.43
Luke Babbitt,2013.0,62,178,116,0.34831460674157305
Luke Babbitt,2014.0,36,95,59,0.37894736842105264
Luke Babbitt,2015.0,59,115,56,0.5130434782608696
Luke Babbitt,2016.0,44,109,65,0.4036697247706422
Luke Babbitt,2017.0,87,210,123,0.4142857142857143
Luke Babbitt,2018.0,60,156,96,0.38461538461538464
Luke Harangody,2011.0,16,66,50,0.24242424242424243
Luke Harangody,2012.0,5,21,16,0.23809523809523808
Luke Jackson,2005.0,4,6,2,0.6666666666666666
Luke Jackson,2006.0,12,36,24,0.3333333333333333
Luke Jackson,2007.0,5,17,12,0.29411764705882354
Luke Jackson,2008.0,11,30,19,0.36666666666666664
Luke Kennard,2018.0,81,195,114,0.4153846153846154
Luke Kennard,2019.0,115,284,169,0.40492957746478875
Luke Kennard,2020.0,73,183,110,0.3989071038251366
Luke Kennard,2021.0,121,275,154,0.44
Luke Kennard,2022.0,190,423,233,0.4491725768321513
Luke Kennard,2023.0,141,285,144,0.49473684210526314
Luke Kennard,2024.0,57,132,75,0.4318181818181818
Luke Kornet,2018.0,28,79,51,0.35443037974683544
Luke Kornet,2019.0,70,193,123,0.3626943005181347
Luke Kornet,2020.0,31,108,77,0.28703703703703703
Luke Kornet,2021.0,15,59,44,0.2542372881355932
Luke Kornet,2022.0,1,6,5,0.16666666666666666
Luke Kornet,2023.0,4,14,10,0.2857142857142857
Luke Ridnour,2004.0,27,80,53,0.3375
Luke Ridnour,2005.0,71,195,124,0.3641025641025641
Luke Ridnour,2006.0,43,149,106,0.28859060402684567
Luke Ridnour,2007.0,49,139,90,0.35251798561151076
Luke Ridnour,2008.0,21,71,50,0.29577464788732394
Luke Ridnour,2009.0,55,157,102,0.3503184713375796
Luke Ridnour,2010.0,74,195,121,0.37948717948717947
Luke Ridnour,2011.0,81,184,103,0.44021739130434784
Luke Ridnour,2012.0,49,152,103,0.3223684210526316
Luke Ridnour,2013.0,66,212,146,0.3113207547169811
Luke Ridnour,2014.0,39,114,75,0.34210526315789475
Luke Ridnour,2015.0,20,63,43,0.31746031746031744
Luke Walton,2004.0,17,51,34,0.3333333333333333
Luke Walton,2005.0,16,61,45,0.26229508196721313
Luke Walton,2006.0,22,66,44,0.3333333333333333
Luke Walton,2007.0,53,136,83,0.3897058823529412
Luke Walton,2008.0,39,110,71,0.35454545454545455
Luke Walton,2009.0,22,73,51,0.3013698630136986
Luke Walton,2010.0,9,26,17,0.34615384615384615
Luke Walton,2011.0,8,36,28,0.2222222222222222
Luke Walton,2012.0,7,20,13,0.35
Luke Walton,2013.0,20,67,47,0.29850746268656714
Luke Zeller,2013.0,1,5,4,0.2
Luol Deng,2005.0,31,117,86,0.26495726495726496
Luol Deng,2006.0,22,82,60,0.2682926829268293
Luol Deng,2007.0,1,8,7,0.125
Luol Deng,2008.0,8,22,14,0.36363636363636365
Luol Deng,2009.0,8,20,12,0.4
Luol Deng,2010.0,33,95,62,0.3473684210526316
Luol Deng,2011.0,137,401,264,0.341645885286783
Luol Deng,2012.0,87,237,150,0.3670886075949367
Luol Deng,2013.0,76,251,175,0.30278884462151395
Luol Deng,2014.0,57,189,132,0.30158730158730157
Luol Deng,2015.0,78,220,142,0.35454545454545455
Luol Deng,2016.0,112,313,201,0.35782747603833864
Luol Deng,2017.0,51,164,113,0.31097560975609756
Luol Deng,2019.0,14,44,30,0.3181818181818182
Luther Head,2006.0,113,313,200,0.3610223642172524
Luther Head,2007.0,183,424,241,0.43160377358490565
Luther Head,2008.0,79,231,152,0.341991341991342
Luther Head,2009.0,20,54,34,0.37037037037037035
Luther Head,2010.0,37,105,68,0.3523809523809524
Luther Head,2011.0,25,64,39,0.390625
Lynn Greer,2007.0,18,52,34,0.34615384615384615
M.J. Walker,2022.0,0,2,2,0.0
Maalik Wayns,2013.0,7,31,24,0.22580645161290322
Mac McClung,2022.0,1,3,2,0.3333333333333333
Mac McClung,2023.0,4,11,7,0.36363636363636365
Maceo Baston,2007.0,3,7,4,0.42857142857142855
Maceo Baston,2009.0,0,1,1,0.0
Maciej Lampe,2004.0,0,4,4,0.0
Maciej Lampe,2005.0,2,4,2,0.5
Malachi Flynn,2021.0,54,168,114,0.32142857142857145
Malachi Flynn,2022.0,30,93,63,0.3225806451612903
Malachi Flynn,2023.0,47,133,86,0.3533834586466165
Malachi Flynn,2024.0,30,88,58,0.3409090909090909
Malachi Richardson,2017.0,8,28,20,0.2857142857142857
Malachi Richardson,2018.0,12,40,28,0.3
Malachi Richardson,2019.0,8,25,17,0.32
Malaki Branham,2023.0,77,255,178,0.30196078431372547
Malaki Branham,2024.0,40,130,90,0.3076923076923077
Malcolm Brogdon,2017.0,88,212,124,0.41509433962264153
Malcolm Brogdon,2018.0,67,180,113,0.37222222222222223
Malcolm Brogdon,2019.0,118,281,163,0.4199288256227758
Malcolm Brogdon,2020.0,84,254,170,0.33070866141732286
Malcolm Brogdon,2021.0,150,381,231,0.3937007874015748
Malcolm Brogdon,2022.0,58,186,128,0.3118279569892473
Malcolm Brogdon,2023.0,165,384,219,0.4296875
Malcolm Brogdon,2024.0,77,186,109,0.41397849462365593
Malcolm Delaney,2017.0,27,110,83,0.24545454545454545
Malcolm Delaney,2018.0,46,124,78,0.3709677419354839
Malcolm Hill,2022.0,13,36,23,0.3611111111111111
Malcolm Hill,2023.0,1,3,2,0.3333333333333333
Malcolm Lee,2012.0,2,10,8,0.2
Malcolm Lee,2013.0,8,24,16,0.3333333333333333
Malcolm Miller,2018.0,8,21,13,0.38095238095238093
Malcolm Miller,2019.0,11,27,16,0.4074074074074074
Malcolm Miller,2020.0,9,23,14,0.391304347826087
Malcolm Thomas,2014.0,1,4,3,0.25
Malcolm Thomas,2015.0,0,7,7,0.0
Malik Allen,2006.0,1,1,0,1.0
Malik Allen,2007.0,0,1,1,0.0
Malik Allen,2008.0,1,2,1,0.5
Malik Allen,2009.0,0,1,1,0.0
Malik Allen,2010.0,1,6,5,0.16666666666666666
Malik Beasley,2017.0,9,28,19,0.32142857142857145
Malik Beasley,2018.0,28,82,54,0.34146341463414637
Malik Beasley,2019.0,182,452,270,0.4026548672566372
Malik Beasley,2020.0,107,276,169,0.38768115942028986
Malik Beasley,2021.0,128,321,193,0.3987538940809969
Malik Beasley,2022.0,248,662,414,0.37462235649546827
Malik Beasley,2023.0,242,684,442,0.3538011695906433
Malik Beasley,2024.0,124,268,144,0.4626865671641791
Malik Fitts,2021.0,1,2,1,0.5
Malik Fitts,2022.0,7,12,5,0.5833333333333334
Malik Hairston,2009.0,0,1,1,0.0
Malik Hairston,2010.0,2,11,9,0.18181818181818182
Malik Monk,2018.0,83,243,160,0.34156378600823045
Malik Monk,2019.0,109,330,221,0.3303030303030303
Malik Monk,2020.0,58,204,146,0.28431372549019607
Malik Monk,2021.0,88,217,129,0.4055299539170507
Malik Monk,2022.0,173,442,269,0.3914027149321267
Malik Monk,2023.0,156,437,281,0.35697940503432496
Malik Monk,2024.0,102,265,163,0.3849056603773585
Malik Newman,2020.0,0,1,1,0.0
Malik Newman,2022.0,0,1,1,0.0
Malik Rose,2004.0,0,5,5,0.0
Malik Rose,2005.0,1,10,9,0.1
Malik Rose,2006.0,1,1,0,1.0
Malik Rose,2007.0,2,8,6,0.25
Malik Rose,2008.0,2,7,5,0.2857142857142857
Malik Rose,2009.0,0,7,7,0.0
Mamadi Diakite,2021.0,2,10,8,0.2
Mamadi Diakite,2022.0,0,5,5,0.0
Mamadi Diakite,2023.0,7,21,14,0.3333333333333333
Mamadou N'Diaye,2005.0,0,1,1,0.0
Manny Harris,2011.0,34,92,58,0.3695652173913043
Manny Harris,2012.0,12,36,24,0.3333333333333333
Manny Harris,2014.0,7,20,13,0.35
Manny Harris,2017.0,0,2,2,0.0
Manu Ginobili,2004.0,98,280,182,0.35
Manu Ginobili,2005.0,139,354,215,0.3926553672316384
Manu Ginobili,2006.0,97,259,162,0.3745173745173745
Manu Ginobili,2007.0,166,422,256,0.3933649289099526
Manu Ginobili,2008.0,194,491,297,0.395112016293279
Manu Ginobili,2009.0,69,209,140,0.33014354066985646
Manu Ginobili,2010.0,152,410,258,0.37073170731707317
Manu Ginobili,2011.0,163,469,306,0.34754797441364604
Manu Ginobili,2012.0,75,194,119,0.3865979381443299
Manu Ginobili,2013.0,112,331,219,0.338368580060423
Manu Ginobili,2014.0,131,363,232,0.3608815426997245
Manu Ginobili,2015.0,97,280,183,0.3464285714285714
Manu Ginobili,2016.0,79,200,121,0.395
Manu Ginobili,2017.0,98,267,169,0.36704119850187267
Manu Ginobili,2018.0,70,210,140,0.3333333333333333
MarJon Beauchamp,2023.0,48,143,95,0.3356643356643357
MarJon Beauchamp,2024.0,25,62,37,0.4032258064516129
MarShon Brooks,2012.0,47,150,103,0.31333333333333335
MarShon Brooks,2013.0,15,56,41,0.26785714285714285
MarShon Brooks,2014.0,13,25,12,0.52
MarShon Brooks,2018.0,19,32,13,0.59375
MarShon Brooks,2019.0,15,54,39,0.2777777777777778
Marc Gasol,2009.0,0,1,1,0.0
Marc Gasol,2010.0,0,1,1,0.0
Marc Gasol,2011.0,3,9,6,0.3333333333333333
Marc Gasol,2012.0,1,13,12,0.07692307692307693
Marc Gasol,2013.0,1,14,13,0.07142857142857142
Marc Gasol,2014.0,2,12,10,0.16666666666666666
Marc Gasol,2015.0,3,19,16,0.15789473684210525
Marc Gasol,2016.0,2,3,1,0.6666666666666666
Marc Gasol,2017.0,109,276,167,0.39492753623188404
Marc Gasol,2018.0,109,320,211,0.340625
Marc Gasol,2019.0,133,362,229,0.3674033149171271
Marc Gasol,2020.0,62,175,113,0.35428571428571426
Marc Gasol,2021.0,57,133,76,0.42857142857142855
Marc Jackson,2004.0,0,1,1,0.0
Marc Jackson,2005.0,0,2,2,0.0
Marc Jackson,2006.0,1,2,1,0.5
Marc Jackson,2007.0,0,1,1,0.0
Marcelo Huertas,2016.0,16,61,45,0.26229508196721313
Marcelo Huertas,2017.0,4,19,15,0.21052631578947367
Marcin Gortat,2009.0,1,1,0,1.0
Marcin Gortat,2010.0,0,3,3,0.0
Marcin Gortat,2011.0,1,4,3,0.25
Marcin Gortat,2012.0,0,2,2,0.0
Marcin Gortat,2013.0,0,3,3,0.0
Marcin Gortat,2014.0,1,1,0,1.0
Marcin Gortat,2015.0,0,3,3,0.0
Marcin Gortat,2016.0,0,1,1,0.0
Marcin Gortat,2017.0,0,2,2,0.0
Marco Belinelli,2008.0,16,41,25,0.3902439024390244
Marco Belinelli,2009.0,52,131,79,0.3969465648854962
Marco Belinelli,2010.0,60,158,98,0.379746835443038
Marco Belinelli,2011.0,142,350,208,0.4057142857142857
Marco Belinelli,2012.0,107,284,177,0.3767605633802817
Marco Belinelli,2013.0,95,268,173,0.35447761194029853
Marco Belinelli,2014.0,142,331,189,0.42900302114803623
Marco Belinelli,2015.0,100,260,160,0.38461538461538464
Marco Belinelli,2016.0,91,297,206,0.3063973063973064
Marco Belinelli,2017.0,102,282,180,0.3617021276595745
Marco Belinelli,2018.0,165,441,276,0.3741496598639456
Marco Belinelli,2019.0,155,416,261,0.37259615384615385
Marco Belinelli,2020.0,67,178,111,0.37640449438202245
Marcus Banks,2004.0,29,89,60,0.3258426966292135
Marcus Banks,2005.0,24,65,41,0.36923076923076925
Marcus Banks,2006.0,22,63,41,0.3492063492063492
Marcus Banks,2007.0,5,30,25,0.16666666666666666
Marcus Banks,2008.0,40,102,62,0.39215686274509803
Marcus Banks,2009.0,3,19,16,0.15789473684210525
Marcus Banks,2010.0,7,24,17,0.2916666666666667
Marcus Camby,2004.0,1,4,3,0.25
Marcus Camby,2005.0,0,4,4,0.0
Marcus Camby,2006.0,1,11,10,0.09090909090909091
Marcus Camby,2007.0,0,2,2,0.0
Marcus Camby,2008.0,7,21,14,0.3333333333333333
Marcus Camby,2009.0,1,4,3,0.25
Marcus Camby,2010.0,2,8,6,0.25
Marcus Camby,2011.0,1,2,1,0.5
Marcus Camby,2012.0,2,5,3,0.4
Marcus Derrickson,2019.0,10,20,10,0.5
Marcus Fizer,2004.0,2,17,15,0.11764705882352941
Marcus Fizer,2005.0,0,6,6,0.0
Marcus Fizer,2006.0,1,1,0,1.0
Marcus Garrett,2022.0,1,4,3,0.25
Marcus Georges-Hunt,2017.0,1,2,1,0.5
Marcus Georges-Hunt,2018.0,4,15,11,0.26666666666666666
Marcus Haislip,2004.0,1,2,1,0.5
Marcus Haislip,2005.0,0,1,1,0.0
Marcus Haislip,2010.0,3,5,2,0.6
Marcus Landry,2010.0,9,28,19,0.32142857142857145
Marcus Morris,2012.0,2,17,15,0.11764705882352941
Marcus Morris,2013.0,86,233,147,0.36909871244635195
Marcus Morris,2014.0,99,260,161,0.38076923076923075
Marcus Morris,2015.0,112,313,201,0.35782747603833864
Marcus Morris,2016.0,115,316,201,0.3639240506329114
Marcus Morris,2017.0,118,358,240,0.329608938547486
Marcus Morris,2018.0,116,306,190,0.3790849673202614
Marcus Morris,2019.0,164,429,265,0.3822843822843823
Marcus Morris,2020.0,170,407,237,0.4176904176904177
Marcus Morris,2021.0,176,392,216,0.4489795918367347
Marcus Morris,2022.0,105,286,181,0.36713286713286714
Marcus Morris,2023.0,114,319,205,0.3573667711598746
Marcus Morris,2024.0,33,82,49,0.4024390243902439
Marcus Paige,2018.0,2,8,6,0.25
Marcus Sasser,2024.0,31,99,68,0.31313131313131315
Marcus Smart,2015.0,94,285,191,0.3298245614035088
Marcus Smart,2016.0,72,273,201,0.26373626373626374
Marcus Smart,2017.0,123,404,281,0.30445544554455445
Marcus Smart,2018.0,90,317,227,0.28391167192429023
Marcus Smart,2019.0,127,357,230,0.3557422969187675
Marcus Smart,2020.0,178,518,340,0.3436293436293436
Marcus Smart,2021.0,110,330,220,0.3333333333333333
Marcus Smart,2022.0,167,497,330,0.33601609657947684
Marcus Smart,2023.0,159,464,305,0.3426724137931034
Marcus Smart,2024.0,42,134,92,0.31343283582089554
Marcus Thornton,2010.0,117,313,196,0.3738019169329074
Marcus Thornton,2011.0,88,240,152,0.36666666666666664
Marcus Thornton,2012.0,107,310,203,0.34516129032258064
Marcus Thornton,2013.0,141,379,238,0.3720316622691293
Marcus Thornton,2014.0,114,337,223,0.33827893175074186
Marcus Thornton,2015.0,54,143,89,0.3776223776223776
Marcus Thornton,2016.0,91,270,179,0.337037037037037
Marcus Thornton,2017.0,28,80,52,0.35
Marcus Vinicius,2007.0,3,7,4,0.42857142857142855
Marcus Vinicius,2008.0,5,12,7,0.4166666666666667
Marcus Williams,2007.0,47,176,129,0.26704545454545453
Marcus Williams,2008.0,54,142,88,0.38028169014084506
Marcus Williams,2009.0,2,6,4,0.3333333333333333
Marcus Williams,2010.0,24,81,57,0.2962962962962963
Mardy Collins,2007.0,13,47,34,0.2765957446808511
Mardy Collins,2008.0,8,32,24,0.25
Mardy Collins,2009.0,13,31,18,0.41935483870967744
Mardy Collins,2010.0,4,17,13,0.23529411764705882
Marial Shayok,2020.0,2,6,4,0.3333333333333333
Mario Chalmers,2009.0,120,332,212,0.3614457831325301
Mario Chalmers,2010.0,82,256,174,0.3203125
Mario Chalmers,2011.0,115,315,200,0.36507936507936506
Mario Chalmers,2012.0,134,352,218,0.3806818181818182
Mario Chalmers,2013.0,147,369,222,0.3983739837398374
Mario Chalmers,2014.0,102,269,167,0.379182156133829
Mario Chalmers,2015.0,73,248,175,0.29435483870967744
Mario Chalmers,2016.0,46,149,103,0.3087248322147651
Mario Chalmers,2018.0,53,191,138,0.2774869109947644
Mario Hezonja,2016.0,67,192,125,0.3489583333333333
Mario Hezonja,2017.0,43,144,101,0.2986111111111111
Mario Hezonja,2018.0,90,267,177,0.33707865168539325
Mario Hezonja,2019.0,42,152,110,0.27631578947368424
Mario Hezonja,2020.0,27,89,62,0.30337078651685395
Mario Kasun,2005.0,0,1,1,0.0
Mario West,2008.0,0,4,4,0.0
Mario West,2009.0,1,2,1,0.5
Mario West,2010.0,0,2,2,0.0
Mario West,2011.0,1,4,3,0.25
Mark Blount,2005.0,0,1,1,0.0
Mark Blount,2007.0,9,31,22,0.2903225806451613
Mark Blount,2008.0,17,44,27,0.38636363636363635
Mark Blount,2009.0,11,27,16,0.4074074074074074
Mark Jackson,2004.0,7,44,37,0.1590909090909091
Mark Jones,2005.0,0,4,4,0.0
Mark Madsen,2004.0,0,6,6,0.0
Mark Madsen,2006.0,0,7,7,0.0
Markel Brown,2015.0,17,66,49,0.25757575757575757
Markel Brown,2016.0,38,121,83,0.3140495867768595
Markel Brown,2018.0,1,5,4,0.2
Markelle Fultz,2018.0,0,1,1,0.0
Markelle Fultz,2019.0,4,14,10,0.2857142857142857
Markelle Fultz,2020.0,42,151,109,0.2781456953642384
Markelle Fultz,2021.0,4,16,12,0.25
Markelle Fultz,2022.0,4,17,13,0.23529411764705882
Markelle Fultz,2023.0,27,87,60,0.3103448275862069
Markelle Fultz,2024.0,0,3,3,0.0
Markieff Morris,2012.0,43,124,81,0.3467741935483871
Markieff Morris,2013.0,45,134,89,0.3358208955223881
Markieff Morris,2014.0,34,108,74,0.3148148148148148
Markieff Morris,2015.0,57,179,122,0.31843575418994413
Markieff Morris,2016.0,47,155,108,0.3032258064516129
Markieff Morris,2017.0,85,234,149,0.36324786324786323
Markieff Morris,2018.0,78,219,141,0.3561643835616438
Markieff Morris,2019.0,70,210,140,0.3333333333333333
Markieff Morris,2020.0,117,298,181,0.3926174496644295
Markieff Morris,2021.0,66,213,147,0.30985915492957744
Markieff Morris,2022.0,13,39,26,0.3333333333333333
Markieff Morris,2023.0,28,71,43,0.39436619718309857
Markieff Morris,2024.0,9,28,19,0.32142857142857145
Marko Guduric,2020.0,25,83,58,0.30120481927710846
Marko Jaric,2004.0,51,150,99,0.34
Marko Jaric,2005.0,56,151,95,0.3708609271523179
Marko Jaric,2006.0,40,133,93,0.3007518796992481
Marko Jaric,2007.0,32,85,53,0.3764705882352941
Marko Jaric,2008.0,46,127,81,0.36220472440944884
Marko Jaric,2009.0,11,28,17,0.39285714285714285
Marko Simonovic,2022.0,1,5,4,0.2
Marko Simonovic,2023.0,1,4,3,0.25
Markus Howard,2021.0,29,91,62,0.31868131868131866
Markus Howard,2022.0,28,70,42,0.4
Marquese Chriss,2017.0,72,224,152,0.32142857142857145
Marquese Chriss,2018.0,56,190,134,0.29473684210526313
Marquese Chriss,2019.0,16,72,56,0.2222222222222222
Marquese Chriss,2020.0,8,39,31,0.20512820512820512
Marquese Chriss,2021.0,1,5,4,0.2
Marquese Chriss,2022.0,9,27,18,0.3333333333333333
Marquis Daniels,2004.0,12,43,31,0.27906976744186046
Marquis Daniels,2005.0,8,41,33,0.1951219512195122
Marquis Daniels,2006.0,6,24,18,0.25
Marquis Daniels,2007.0,6,26,20,0.23076923076923078
Marquis Daniels,2008.0,27,102,75,0.2647058823529412
Marquis Daniels,2009.0,18,90,72,0.2
Marquis Daniels,2010.0,7,30,23,0.23333333333333334
Marquis Daniels,2011.0,4,21,17,0.19047619047619047
Marquis Daniels,2012.0,0,12,12,0.0
Marquis Daniels,2013.0,20,74,54,0.2702702702702703
Marquis Teague,2013.0,4,28,24,0.14285714285714285
Marquis Teague,2014.0,5,18,13,0.2777777777777778
Marquis Teague,2018.0,1,4,3,0.25
Marreese Speights,2009.0,2,8,6,0.25
Marreese Speights,2010.0,0,5,5,0.0
Marreese Speights,2011.0,1,4,3,0.25
Marreese Speights,2012.0,0,3,3,0.0
Marreese Speights,2013.0,3,10,7,0.3
Marreese Speights,2014.0,8,31,23,0.25806451612903225
Marreese Speights,2015.0,5,18,13,0.2777777777777778
Marreese Speights,2016.0,42,105,63,0.4
Marreese Speights,2017.0,110,297,187,0.37037037037037035
Marreese Speights,2018.0,86,233,147,0.36909871244635195
Martell Webster,2006.0,65,182,117,0.35714285714285715
Martell Webster,2007.0,91,250,159,0.364
Martell Webster,2008.0,123,317,194,0.38801261829652994
Martell Webster,2009.0,0,1,1,0.0
Martell Webster,2010.0,129,349,220,0.36962750716332377
Martell Webster,2011.0,55,132,77,0.4166666666666667
Martell Webster,2012.0,37,109,72,0.3394495412844037
Martell Webster,2013.0,139,329,190,0.42249240121580545
Martell Webster,2014.0,152,398,246,0.38190954773869346
Martell Webster,2015.0,10,44,34,0.22727272727272727
Marvin Bagley,2019.0,30,96,66,0.3125
Marvin Bagley,2020.0,4,22,18,0.18181818181818182
Marvin Bagley,2021.0,37,108,71,0.3425925925925926
Marvin Bagley,2022.0,23,97,74,0.23711340206185566
Marvin Bagley,2023.0,19,66,47,0.2878787878787879
Marvin Bagley,2024.0,2,9,7,0.2222222222222222
Marvin Williams,2006.0,13,52,39,0.25
Marvin Williams,2007.0,11,45,34,0.24444444444444444
Marvin Williams,2008.0,1,10,9,0.1
Marvin Williams,2009.0,56,161,105,0.34782608695652173
Marvin Williams,2010.0,41,134,93,0.30597014925373134
Marvin Williams,2011.0,40,121,81,0.3305785123966942
Marvin Williams,2012.0,66,165,99,0.4
Marvin Williams,2013.0,54,166,112,0.3253012048192771
Marvin Williams,2014.0,84,234,150,0.358974358974359
Marvin Williams,2015.0,95,265,170,0.3584905660377358
Marvin Williams,2016.0,158,395,237,0.4
Marvin Williams,2017.0,124,353,229,0.35127478753541075
Marvin Williams,2018.0,126,306,180,0.4117647058823529
Marvin Williams,2019.0,140,382,242,0.36649214659685864
Marvin Williams,2020.0,66,179,113,0.3687150837988827
Mason Jones,2021.0,24,66,42,0.36363636363636365
Mason Jones,2022.0,1,4,3,0.25
Mason Plumlee,2014.0,0,3,3,0.0
Mason Plumlee,2015.0,0,3,3,0.0
Mason Plumlee,2016.0,0,4,4,0.0
Mason Plumlee,2017.0,0,6,6,0.0
Mason Plumlee,2018.0,0,1,1,0.0
Mason Plumlee,2019.0,2,11,9,0.18181818181818182
Mason Plumlee,2020.0,0,6,6,0.0
Mason Plumlee,2021.0,0,7,7,0.0
Mason Plumlee,2022.0,0,2,2,0.0
Mateen Cleaves,2004.0,0,1,1,0.0
Mateen Cleaves,2005.0,0,2,2,0.0
Mateen Cleaves,2006.0,4,16,12,0.25
Matisse Thybulle,2020.0,57,161,104,0.35403726708074534
Matisse Thybulle,2021.0,54,177,123,0.3050847457627119
Matisse Thybulle,2022.0,49,158,109,0.310126582278481
Matisse Thybulle,2023.0,54,148,94,0.36486486486486486
Matisse Thybulle,2024.0,60,161,101,0.37267080745341613
Matt Barnes,2004.0,2,13,11,0.15384615384615385
Matt Barnes,2005.0,5,22,17,0.22727272727272727
Matt Barnes,2006.0,3,15,12,0.2
Matt Barnes,2007.0,125,335,210,0.373134328358209
Matt Barnes,2008.0,53,181,128,0.292817679558011
Matt Barnes,2009.0,117,341,224,0.34310850439882695
Matt Barnes,2010.0,78,239,161,0.3263598326359833
Matt Barnes,2011.0,36,119,83,0.3025210084033613
Matt Barnes,2012.0,51,169,118,0.30177514792899407
Matt Barnes,2013.0,118,342,224,0.34502923976608185
Matt Barnes,2014.0,116,343,227,0.33819241982507287
Matt Barnes,2015.0,152,436,284,0.3486238532110092
Matt Barnes,2016.0,122,388,266,0.31443298969072164
Matt Barnes,2017.0,88,271,183,0.3247232472324723
Matt Bonner,2005.0,39,92,53,0.42391304347826086
Matt Bonner,2006.0,102,243,141,0.41975308641975306
Matt Bonner,2007.0,37,98,61,0.37755102040816324
Matt Bonner,2008.0,46,137,91,0.3357664233576642
Matt Bonner,2009.0,121,281,160,0.4306049822064057
Matt Bonner,2010.0,100,258,158,0.3875968992248062
Matt Bonner,2011.0,111,248,137,0.4475806451612903
Matt Bonner,2012.0,113,273,160,0.4139194139194139
Matt Bonner,2013.0,68,152,84,0.4473684210526316
Matt Bonner,2014.0,46,110,64,0.41818181818181815
Matt Bonner,2015.0,48,135,87,0.35555555555555557
Matt Bonner,2016.0,15,34,19,0.4411764705882353
Matt Carroll,2004.0,1,3,2,0.3333333333333333
Matt Carroll,2005.0,13,39,26,0.3333333333333333
Matt Carroll,2006.0,69,179,110,0.3854748603351955
Matt Carroll,2007.0,111,267,156,0.4157303370786517
Matt Carroll,2008.0,105,241,136,0.43568464730290457
Matt Carroll,2009.0,13,53,40,0.24528301886792453
Matt Carroll,2010.0,4,19,15,0.21052631578947367
Matt Carroll,2011.0,17,46,29,0.3695652173913043
Matt Carroll,2012.0,8,43,35,0.18604651162790697
Matt Freije,2005.0,14,54,40,0.25925925925925924
Matt Freije,2007.0,3,22,19,0.13636363636363635
Matt Harpring,2004.0,8,33,25,0.24242424242424243
Matt Harpring,2005.0,9,43,34,0.20930232558139536
Matt Harpring,2006.0,14,39,25,0.358974358974359
Matt Harpring,2007.0,13,43,30,0.3023255813953488
Matt Harpring,2008.0,3,13,10,0.23076923076923078
Matt Harpring,2009.0,0,3,3,0.0
Matt Mooney,2020.0,0,2,2,0.0
Matt Mooney,2022.0,0,1,1,0.0
Matt Ryan,2022.0,1,5,4,0.2
Matt Ryan,2023.0,32,84,52,0.38095238095238093
Matt Ryan,2024.0,32,68,36,0.47058823529411764
Matt Thomas,2020.0,52,111,59,0.46846846846846846
Matt Thomas,2021.0,27,80,53,0.3375
Matt Thomas,2022.0,35,91,56,0.38461538461538464
Matt Williams,2018.0,1,5,4,0.2
Matthew Dellavedova,2014.0,57,155,98,0.36774193548387096
Matthew Dellavedova,2015.0,92,243,151,0.3786008230452675
Matthew Dellavedova,2016.0,106,270,164,0.3925925925925926
Matthew Dellavedova,2017.0,85,233,148,0.3648068669527897
Matthew Dellavedova,2018.0,31,87,56,0.3563218390804598
Matthew Dellavedova,2019.0,44,130,86,0.3384615384615385
Matthew Dellavedova,2020.0,21,91,70,0.23076923076923078
Matthew Dellavedova,2021.0,4,25,21,0.16
Matthew Dellavedova,2023.0,9,27,18,0.3333333333333333
Maurice Ager,2007.0,7,18,11,0.3888888888888889
Maurice Ager,2008.0,3,19,16,0.15789473684210525
Maurice Ager,2009.0,0,6,6,0.0
Maurice Ager,2011.0,3,4,1,0.75
Maurice Carter,2004.0,4,11,7,0.36363636363636365
Maurice Evans,2005.0,29,86,57,0.3372093023255814
Maurice Evans,2006.0,50,127,77,0.3937007874015748
Maurice Evans,2007.0,53,146,93,0.363013698630137
Maurice Evans,2008.0,96,245,149,0.39183673469387753
Maurice Evans,2009.0,106,276,170,0.38405797101449274
Maurice Evans,2010.0,60,179,119,0.33519553072625696
Maurice Evans,2011.0,55,167,112,0.32934131736526945
Maurice Evans,2012.0,17,45,28,0.37777777777777777
Maurice Harkless,2013.0,32,117,85,0.27350427350427353
Maurice Harkless,2014.0,59,154,95,0.38311688311688313
Maurice Harkless,2015.0,10,56,46,0.17857142857142858
Maurice Harkless,2016.0,54,184,130,0.29347826086956524
Maurice Harkless,2017.0,70,206,136,0.33980582524271846
Maurice Harkless,2018.0,51,124,73,0.4112903225806452
Maurice Harkless,2019.0,40,148,108,0.2702702702702703
Maurice Harkless,2020.0,34,98,64,0.3469387755102041
Maurice Harkless,2021.0,23,84,61,0.27380952380952384
Maurice Harkless,2022.0,31,101,70,0.3069306930693069
Maurice Ndour,2017.0,1,7,6,0.14285714285714285
Maurice Taylor,2004.0,0,2,2,0.0
Maurice Taylor,2005.0,3,9,6,0.3333333333333333
Maurice Taylor,2006.0,0,1,1,0.0
Max Christie,2023.0,27,66,39,0.4090909090909091
Max Christie,2024.0,25,79,54,0.31645569620253167
Max Strus,2020.0,0,1,1,0.0
Max Strus,2021.0,50,148,98,0.33783783783783783
Max Strus,2022.0,228,584,356,0.3904109589041096
Max Strus,2023.0,240,698,458,0.3438395415472779
Max Strus,2024.0,109,324,215,0.33641975308641975
Maxi Kleber,2018.0,40,128,88,0.3125
Maxi Kleber,2019.0,77,218,141,0.3532110091743119
Maxi Kleber,2020.0,124,345,221,0.35942028985507246
Maxi Kleber,2021.0,95,232,137,0.40948275862068967
Maxi Kleber,2022.0,117,333,216,0.35135135135135137
Maxi Kleber,2023.0,39,112,73,0.3482142857142857
Maxi Kleber,2024.0,6,23,17,0.2608695652173913
Maxwell Lewis,2024.0,1,3,2,0.3333333333333333
McKinley Wright,2022.0,1,2,1,0.5
McKinley Wright,2023.0,9,28,19,0.32142857142857145
Mehmet Okur,2004.0,20,53,33,0.37735849056603776
Mehmet Okur,2005.0,17,63,46,0.2698412698412698
Mehmet Okur,2006.0,80,234,154,0.3418803418803419
Mehmet Okur,2007.0,154,415,261,0.3710843373493976
Mehmet Okur,2008.0,133,345,212,0.3855072463768116
Mehmet Okur,2009.0,91,205,114,0.44390243902439025
Mehmet Okur,2010.0,83,214,131,0.3878504672897196
Mehmet Okur,2011.0,5,16,11,0.3125
Mehmet Okur,2012.0,23,72,49,0.3194444444444444
Melvin Ely,2004.0,0,1,1,0.0
Melvin Ely,2006.0,0,2,2,0.0
Melvin Frazier,2019.0,0,6,6,0.0
Melvin Frazier,2020.0,8,16,8,0.5
Melvin Frazier,2022.0,1,21,20,0.047619047619047616
Melvin Sanders,2006.0,2,3,1,0.6666666666666666
Metta World Peace,2004.0,94,308,214,0.3051948051948052
Metta World Peace,2005.0,7,17,10,0.4117647058823529
Metta World Peace,2006.0,87,280,193,0.3107142857142857
Metta World Peace,2007.0,93,260,167,0.3576923076923077
Metta World Peace,2008.0,84,221,137,0.38009049773755654
Metta World Peace,2009.0,176,466,290,0.3776824034334764
Metta World Peace,2010.0,139,413,274,0.3365617433414044
Metta World Peace,2011.0,92,261,169,0.3524904214559387
Metta World Peace,2012.0,70,225,155,0.3111111111111111
Metta World Peace,2013.0,143,426,283,0.33568075117370894
Metta World Peace,2014.0,17,54,37,0.3148148148148148
Metta World Peace,2016.0,26,84,58,0.30952380952380953
Metta World Peace,2017.0,9,38,29,0.23684210526315788
Meyers Leonard,2013.0,3,7,4,0.42857142857142855
Meyers Leonard,2014.0,0,6,6,0.0
Meyers Leonard,2015.0,57,125,68,0.456
Meyers Leonard,2016.0,86,228,142,0.37719298245614036
Meyers Leonard,2017.0,74,217,143,0.34101382488479265
Meyers Leonard,2018.0,11,26,15,0.4230769230769231
Meyers Leonard,2019.0,64,144,80,0.4444444444444444
Meyers Leonard,2020.0,55,132,77,0.4166666666666667
Meyers Leonard,2021.0,3,7,4,0.42857142857142855
Meyers Leonard,2023.0,7,18,11,0.3888888888888889
Mfiondu Kabengele,2020.0,9,20,11,0.45
Mfiondu Kabengele,2021.0,13,50,37,0.26
Mfiondu Kabengele,2023.0,0,3,3,0.0
Micah Potter,2022.0,0,2,2,0.0
Micah Potter,2023.0,4,7,3,0.5714285714285714
Micah Potter,2024.0,0,1,1,0.0
Michael Beasley,2009.0,37,94,57,0.39361702127659576
Michael Beasley,2010.0,29,104,75,0.27884615384615385
Michael Beasley,2011.0,60,164,104,0.36585365853658536
Michael Beasley,2012.0,38,101,63,0.37623762376237624
Michael Beasley,2013.0,45,144,99,0.3125
Michael Beasley,2014.0,21,54,33,0.3888888888888889
Michael Beasley,2015.0,8,34,26,0.23529411764705882
Michael Beasley,2016.0,5,15,10,0.3333333333333333
Michael Beasley,2017.0,21,48,27,0.4375
Michael Beasley,2018.0,34,86,52,0.3953488372093023
Michael Beasley,2019.0,3,17,14,0.17647058823529413
Michael Bradley,2005.0,0,1,1,0.0
Michael Bradley,2006.0,1,5,4,0.2
Michael Carter-Williams,2014.0,55,208,153,0.2644230769230769
Michael Carter-Williams,2015.0,36,158,122,0.22784810126582278
Michael Carter-Williams,2016.0,15,55,40,0.2727272727272727
Michael Carter-Williams,2017.0,15,65,50,0.23076923076923078
Michael Carter-Williams,2018.0,14,59,45,0.23728813559322035
Michael Carter-Williams,2019.0,12,46,34,0.2608695652173913
Michael Carter-Williams,2020.0,22,75,53,0.29333333333333333
Michael Carter-Williams,2021.0,15,61,46,0.2459016393442623
Michael Carter-Williams,2023.0,1,3,2,0.3333333333333333
Michael Curry,2004.0,3,15,12,0.2
Michael Doleac,2005.0,0,2,2,0.0
Michael Doleac,2007.0,0,1,1,0.0
Michael Finley,2004.0,157,392,235,0.4005102040816326
Michael Finley,2005.0,140,346,206,0.4046242774566474
Michael Finley,2006.0,128,326,198,0.39263803680981596
Michael Finley,2007.0,148,391,243,0.37851662404092073
Michael Finley,2008.0,151,409,258,0.3691931540342298
Michael Finley,2009.0,138,334,196,0.41317365269461076
Michael Finley,2010.0,35,93,58,0.3763440860215054
Michael Frazier,2020.0,5,25,20,0.2
Michael Gbinije,2017.0,0,4,4,0.0
Michael Kidd-Gilchrist,2013.0,2,9,7,0.2222222222222222
Michael Kidd-Gilchrist,2014.0,1,10,9,0.1
Michael Kidd-Gilchrist,2016.0,3,7,4,0.42857142857142855
Michael Kidd-Gilchrist,2017.0,1,9,8,0.1111111111111111
Michael Kidd-Gilchrist,2018.0,0,2,2,0.0
Michael Kidd-Gilchrist,2019.0,16,47,31,0.3404255319148936
Michael Kidd-Gilchrist,2020.0,7,29,22,0.2413793103448276
Michael Olowokandi,2004.0,0,1,1,0.0
Michael Porter Jr.,2020.0,96,236,140,0.4067796610169492
Michael Porter Jr.,2021.0,199,455,256,0.43736263736263736
Michael Porter Jr.,2022.0,10,48,38,0.20833333333333334
Michael Porter Jr.,2023.0,234,585,351,0.4
Michael Porter Jr.,2024.0,128,321,193,0.3987538940809969
Michael Redd,2004.0,133,383,250,0.3472584856396867
Michael Redd,2005.0,104,293,189,0.35494880546075086
Michael Redd,2006.0,170,428,258,0.397196261682243
Michael Redd,2007.0,117,306,189,0.38235294117647056
Michael Redd,2008.0,130,359,229,0.362116991643454
Michael Redd,2009.0,70,191,121,0.36649214659685864
Michael Redd,2010.0,18,60,42,0.3
Michael Redd,2011.0,4,17,13,0.23529411764705882
Michael Redd,2012.0,42,132,90,0.3181818181818182
Michael Ruffin,2005.0,0,1,1,0.0
Michael Ruffin,2006.0,0,2,2,0.0
Michael Ruffin,2007.0,0,1,1,0.0
Mickael Gelabale,2007.0,11,47,36,0.23404255319148937
Mickael Gelabale,2008.0,16,37,21,0.43243243243243246
Mickael Gelabale,2013.0,16,52,36,0.3076923076923077
Mickael Pietrus,2004.0,35,105,70,0.3333333333333333
Mickael Pietrus,2005.0,67,195,128,0.3435897435897436
Mickael Pietrus,2006.0,56,176,120,0.3181818181818182
Mickael Pietrus,2007.0,100,267,167,0.37453183520599254
Mickael Pietrus,2008.0,66,183,117,0.36065573770491804
Mickael Pietrus,2009.0,117,319,202,0.3667711598746082
Mickael Pietrus,2010.0,144,367,223,0.3923705722070845
Mickael Pietrus,2011.0,85,236,151,0.3601694915254237
Mickael Pietrus,2012.0,73,236,163,0.3093220338983051
Mickael Pietrus,2013.0,20,64,44,0.3125
Mikal Bridges,2019.0,105,313,208,0.3354632587859425
Mikal Bridges,2020.0,70,194,124,0.36082474226804123
Mikal Bridges,2021.0,169,410,241,0.4121951219512195
Mikal Bridges,2022.0,128,344,216,0.37209302325581395
Mikal Bridges,2023.0,179,467,288,0.38329764453961457
Mikal Bridges,2024.0,102,283,181,0.36042402826855124
Mike Bibby,2004.0,172,433,261,0.3972286374133949
Mike Bibby,2005.0,136,387,251,0.35142118863049093
Mike Bibby,2006.0,201,523,322,0.384321223709369
Mike Bibby,2007.0,173,481,308,0.3596673596673597
Mike Bibby,2008.0,100,272,172,0.36764705882352944
Mike Bibby,2009.0,193,476,283,0.4054621848739496
Mike Bibby,2010.0,140,358,218,0.39106145251396646
Mike Bibby,2011.0,170,414,244,0.4106280193236715
Mike Bibby,2012.0,34,102,68,0.3333333333333333
Mike Conley,2008.0,30,91,61,0.32967032967032966
Mike Conley,2009.0,88,217,129,0.4055299539170507
Mike Conley,2010.0,82,212,130,0.3867924528301887
Mike Conley,2011.0,91,254,163,0.35826771653543305
Mike Conley,2012.0,71,181,110,0.39226519337016574
Mike Conley,2013.0,124,357,233,0.3473389355742297
Mike Conley,2014.0,108,318,210,0.33962264150943394
Mike Conley,2015.0,117,310,193,0.3774193548387097
Mike Conley,2016.0,78,215,137,0.3627906976744186
Mike Conley,2017.0,185,452,267,0.4092920353982301
Mike Conley,2018.0,24,77,53,0.3116883116883117
Mike Conley,2019.0,155,426,271,0.36384976525821594
Mike Conley,2020.0,114,290,176,0.3931034482758621
Mike Conley,2021.0,156,372,216,0.41935483870967744
Mike Conley,2022.0,174,439,265,0.39635535307517084
Mike Conley,2023.0,145,373,228,0.38873994638069703
Mike Conley,2024.0,98,223,125,0.43946188340807174
Mike Dunleavy,2004.0,94,254,160,0.3700787401574803
Mike Dunleavy,2005.0,107,276,169,0.38768115942028986
Mike Dunleavy,2006.0,74,260,186,0.2846153846153846
Mike Dunleavy,2007.0,70,224,154,0.3125
Mike Dunleavy,2008.0,165,389,224,0.4241645244215938
Mike Dunleavy,2009.0,32,90,58,0.35555555555555557
Mike Dunleavy,2010.0,75,236,161,0.3177966101694915
Mike Dunleavy,2011.0,105,264,159,0.3977272727272727
Mike Dunleavy,2012.0,83,208,125,0.39903846153846156
Mike Dunleavy,2013.0,135,315,180,0.42857142857142855
Mike Dunleavy,2014.0,135,350,215,0.38571428571428573
Mike Dunleavy,2015.0,134,319,185,0.4200626959247649
Mike Dunleavy,2016.0,39,99,60,0.3939393939393939
Mike Dunleavy,2017.0,55,139,84,0.39568345323741005
Mike Harris,2008.0,0,2,2,0.0
Mike Harris,2010.0,0,1,1,0.0
Mike Harris,2014.0,0,2,2,0.0
Mike James,2004.0,110,289,179,0.3806228373702422
Mike James,2005.0,100,268,168,0.373134328358209
Mike James,2006.0,169,382,213,0.4424083769633508
Mike James,2007.0,80,215,135,0.37209302325581395
Mike James,2008.0,33,102,69,0.3235294117647059
Mike James,2009.0,69,184,115,0.375
Mike James,2010.0,2,6,4,0.3333333333333333
Mike James,2012.0,6,10,4,0.6
Mike James,2013.0,48,125,77,0.384
Mike James,2014.0,1,5,4,0.2
Mike James,2018.0,26,98,72,0.2653061224489796
Mike James,2021.0,16,47,31,0.3404255319148936
Mike Miller,2004.0,85,228,143,0.37280701754385964
Mike Miller,2005.0,148,340,192,0.43529411764705883
Mike Miller,2006.0,139,347,208,0.40057636887608067
Mike Miller,2007.0,202,498,296,0.40562248995983935
Mike Miller,2008.0,155,359,204,0.43175487465181056
Mike Miller,2009.0,85,225,140,0.37777777777777777
Mike Miller,2010.0,82,171,89,0.47953216374269003
Mike Miller,2011.0,54,155,101,0.34838709677419355
Mike Miller,2012.0,84,192,108,0.4375
Mike Miller,2013.0,89,211,122,0.4218009478672986
Mike Miller,2014.0,121,262,141,0.4618320610687023
Mike Miller,2015.0,35,103,68,0.33980582524271846
Mike Miller,2016.0,19,52,33,0.36538461538461536
Mike Miller,2017.0,8,20,12,0.4
Mike Muscala,2014.0,0,3,3,0.0
Mike Muscala,2015.0,11,30,19,0.36666666666666664
Mike Muscala,2016.0,14,45,31,0.3111111111111111
Mike Muscala,2017.0,46,114,68,0.40350877192982454
Mike Muscala,2018.0,62,167,105,0.3712574850299401
Mike Muscala,2019.0,89,256,167,0.34765625
Mike Muscala,2020.0,55,144,89,0.3819444444444444
Mike Muscala,2021.0,68,184,116,0.3695652173913043
Mike Muscala,2022.0,70,163,93,0.4294478527607362
Mike Muscala,2023.0,83,211,128,0.3933649289099526
Mike Muscala,2024.0,21,67,46,0.31343283582089554
Mike Scott,2013.0,0,2,2,0.0
Mike Scott,2014.0,72,231,159,0.3116883116883117
Mike Scott,2015.0,70,218,148,0.3211009174311927
Mike Scott,2016.0,70,174,104,0.40229885057471265
Mike Scott,2017.0,4,27,23,0.14814814814814814
Mike Scott,2018.0,73,174,101,0.41954022988505746
Mike Scott,2019.0,113,286,173,0.3951048951048951
Mike Scott,2020.0,80,219,139,0.365296803652968
Mike Scott,2021.0,55,162,107,0.3395061728395062
Mike Sweetney,2004.0,0,1,1,0.0
Mike Sweetney,2005.0,0,1,1,0.0
Mike Taylor,2009.0,13,40,27,0.325
Mike Wilks,2004.0,6,10,4,0.6
Mike Wilks,2005.0,5,16,11,0.3125
Mike Wilks,2006.0,3,19,16,0.15789473684210525
Mike Wilks,2007.0,5,15,10,0.3333333333333333
Mike Wilks,2008.0,3,8,5,0.375
Mike Wilks,2010.0,2,3,1,0.6666666666666666
Mikki Moore,2005.0,1,5,4,0.2
Mikki Moore,2006.0,0,2,2,0.0
Mikki Moore,2007.0,0,1,1,0.0
Mikki Moore,2008.0,0,2,2,0.0
Miles Bridges,2019.0,65,200,135,0.325
Miles Bridges,2020.0,99,300,201,0.33
Miles Bridges,2021.0,118,295,177,0.4
Miles Bridges,2022.0,154,468,314,0.32905982905982906
Miles Bridges,2024.0,77,215,138,0.3581395348837209
Miles McBride,2022.0,17,68,51,0.25
Miles McBride,2023.0,41,137,96,0.29927007299270075
Miles McBride,2024.0,35,75,40,0.4666666666666667
Milos Teodosic,2018.0,88,232,144,0.3793103448275862
Milos Teodosic,2019.0,10,27,17,0.37037037037037035
Milt Palacio,2004.0,4,26,22,0.15384615384615385
Milt Palacio,2005.0,2,12,10,0.16666666666666666
Milt Palacio,2006.0,1,16,15,0.0625
Milton Doyle,2018.0,4,23,19,0.17391304347826086
Mindaugas Kuzminskas,2017.0,54,168,114,0.32142857142857145
Mirza Teletovic,2013.0,37,108,71,0.3425925925925926
Mirza Teletovic,2014.0,155,405,250,0.38271604938271603
Mirza Teletovic,2015.0,62,197,135,0.3147208121827411
Mirza Teletovic,2016.0,181,460,279,0.3934782608695652
Mirza Teletovic,2017.0,105,309,204,0.33980582524271846
Mirza Teletovic,2018.0,21,45,24,0.4666666666666667
Mitch Creek,2019.0,0,2,2,0.0
Mitch McGary,2015.0,0,2,2,0.0
Mitch McGary,2016.0,0,4,4,0.0
Mitchell Butler,2004.0,11,30,19,0.36666666666666664
Miye Oni,2020.0,8,23,15,0.34782608695652173
Miye Oni,2021.0,30,93,63,0.3225806451612903
Miye Oni,2022.0,1,8,7,0.125
Mo Williams,2004.0,10,39,29,0.2564102564102564
Mo Williams,2005.0,32,99,67,0.32323232323232326
Mo Williams,2006.0,75,202,127,0.3712871287128713
Mo Williams,2007.0,79,228,149,0.34649122807017546
Mo Williams,2008.0,89,231,142,0.3852813852813853
Mo Williams,2009.0,218,514,296,0.42412451361867703
Mo Williams,2010.0,176,423,247,0.4160756501182033
Mo Williams,2011.0,79,244,165,0.3237704918032787
Mo Williams,2012.0,105,272,167,0.3860294117647059
Mo Williams,2013.0,59,154,95,0.38311688311688313
Mo Williams,2014.0,88,246,158,0.35772357723577236
Mo Williams,2015.0,119,348,229,0.34195402298850575
Mo Williams,2016.0,39,115,76,0.3391304347826087
Mohamed Bamba,2019.0,21,70,49,0.3
Mohamed Bamba,2020.0,37,107,70,0.34579439252336447
Mohamed Bamba,2021.0,38,118,80,0.3220338983050847
Mohamed Bamba,2022.0,107,281,174,0.3807829181494662
Mohamed Bamba,2023.0,48,125,77,0.384
Mohamed Bamba,2024.0,10,18,8,0.5555555555555556
Monta Ellis,2006.0,28,82,54,0.34146341463414637
Monta Ellis,2007.0,40,152,112,0.2631578947368421
Monta Ellis,2008.0,12,52,40,0.23076923076923078
Monta Ellis,2009.0,8,26,18,0.3076923076923077
Monta Ellis,2010.0,77,228,151,0.33771929824561403
Monta Ellis,2011.0,137,379,242,0.36147757255936674
Monta Ellis,2012.0,62,201,139,0.30845771144278605
Monta Ellis,2013.0,97,347,250,0.27953890489913547
Monta Ellis,2014.0,81,243,162,0.3333333333333333
Monta Ellis,2015.0,92,314,222,0.2929936305732484
Monta Ellis,2016.0,94,303,209,0.3102310231023102
Monta Ellis,2017.0,45,143,98,0.3146853146853147
Monte Morris,2018.0,0,1,1,0.0
Monte Morris,2019.0,94,240,146,0.39166666666666666
Monte Morris,2020.0,77,212,135,0.3632075471698113
Monte Morris,2021.0,67,174,107,0.3850574712643678
Monte Morris,2022.0,135,340,205,0.39705882352941174
Monte Morris,2023.0,78,204,126,0.38235294117647056
Monte Morris,2024.0,2,5,3,0.4
Montrezl Harrell,2016.0,0,2,2,0.0
Montrezl Harrell,2017.0,1,7,6,0.14285714285714285
Montrezl Harrell,2018.0,1,7,6,0.14285714285714285
Montrezl Harrell,2019.0,3,18,15,0.16666666666666666
Montrezl Harrell,2020.0,1,23,22,0.043478260869565216
Montrezl Harrell,2021.0,0,10,10,0.0
Montrezl Harrell,2022.0,4,17,13,0.23529411764705882
Montrezl Harrell,2023.0,0,6,6,0.0
Moochie Norris,2004.0,20,58,38,0.3448275862068966
Moochie Norris,2005.0,0,12,12,0.0
Moochie Norris,2006.0,4,14,10,0.2857142857142857
Moritz Wagner,2019.0,22,77,55,0.2857142857142857
Moritz Wagner,2020.0,25,80,55,0.3125
Moritz Wagner,2021.0,31,91,60,0.34065934065934067
Moritz Wagner,2022.0,66,201,135,0.3283582089552239
Moritz Wagner,2023.0,51,163,112,0.3128834355828221
Moritz Wagner,2024.0,23,72,49,0.3194444444444444
Morris Almond,2008.0,1,4,3,0.25
Morris Almond,2009.0,5,17,12,0.29411764705882354
Morris Almond,2012.0,1,3,2,0.3333333333333333
Morris Peterson,2004.0,126,340,214,0.37058823529411766
Morris Peterson,2005.0,129,335,206,0.3850746268656716
Morris Peterson,2006.0,177,448,271,0.3950892857142857
Morris Peterson,2007.0,112,307,195,0.36482084690553745
Morris Peterson,2008.0,129,321,192,0.40186915887850466
Morris Peterson,2009.0,34,88,54,0.38636363636363635
Morris Peterson,2010.0,62,171,109,0.36257309941520466
Morris Peterson,2011.0,0,1,1,0.0
Moses Moody,2022.0,47,123,76,0.3821138211382114
Moses Moody,2023.0,62,157,95,0.39490445859872614
Moses Moody,2024.0,38,106,68,0.3584905660377358
Moses Wright,2022.0,0,1,1,0.0
Mouhamed Gueye,2024.0,0,1,1,0.0
Moussa Diabate,2023.0,1,2,1,0.5
Mustafa Shakur,2011.0,1,10,9,0.1
Mustafa Shakur,2014.0,0,1,1,0.0
Mychal Mulder,2020.0,16,52,36,0.3076923076923077
Mychal Mulder,2021.0,86,220,134,0.39090909090909093
Mychal Mulder,2022.0,17,54,37,0.3148148148148148
Mychel Thompson,2012.0,4,11,7,0.36363636363636365
Myke Henry,2018.0,19,58,39,0.3275862068965517
Myles Powell,2022.0,1,6,5,0.16666666666666666
Myles Turner,2016.0,3,16,13,0.1875
Myles Turner,2017.0,40,123,83,0.3252032520325203
Myles Turner,2018.0,62,170,108,0.36470588235294116
Myles Turner,2019.0,79,210,131,0.3761904761904762
Myles Turner,2020.0,92,264,172,0.3484848484848485
Myles Turner,2021.0,69,206,137,0.33495145631067963
Myles Turner,2022.0,61,184,123,0.33152173913043476
Myles Turner,2023.0,93,249,156,0.37349397590361444
Myles Turner,2024.0,63,188,125,0.3351063829787234
Naji Marshall,2021.0,29,83,54,0.3493975903614458
Naji Marshall,2022.0,21,106,85,0.19811320754716982
Naji Marshall,2023.0,66,218,152,0.30275229357798167
Naji Marshall,2024.0,32,85,53,0.3764705882352941
Nando De Colo,2013.0,31,85,54,0.36470588235294116
Nando De Colo,2014.0,18,53,35,0.33962264150943394
Nassir Little,2020.0,14,59,45,0.23728813559322035
Nassir Little,2021.0,29,84,55,0.34523809523809523
Nassir Little,2022.0,51,154,103,0.33116883116883117
Nassir Little,2023.0,58,158,100,0.3670886075949367
Nassir Little,2024.0,16,52,36,0.3076923076923077
Nate Darling,2021.0,2,7,5,0.2857142857142857
Nate Hinton,2021.0,4,19,15,0.21052631578947367
Nate Hinton,2024.0,2,3,1,0.6666666666666666
Nate Robinson,2006.0,58,146,88,0.3972602739726027
Nate Robinson,2007.0,83,213,130,0.38967136150234744
Nate Robinson,2008.0,97,291,194,0.3333333333333333
Nate Robinson,2009.0,125,385,260,0.3246753246753247
Nate Robinson,2010.0,98,256,158,0.3828125
Nate Robinson,2011.0,67,206,139,0.32524271844660196
Nate Robinson,2012.0,66,181,115,0.36464088397790057
Nate Robinson,2013.0,163,413,250,0.3946731234866828
Nate Robinson,2014.0,58,154,96,0.37662337662337664
Nate Robinson,2015.0,31,112,81,0.2767857142857143
Nate Robinson,2016.0,0,1,1,0.0
Nate Wolters,2014.0,18,62,44,0.2903225806451613
Nate Wolters,2015.0,0,7,7,0.0
Nathan Jawai,2010.0,0,1,1,0.0
Nathan Knight,2021.0,6,35,29,0.17142857142857143
Nathan Knight,2022.0,4,13,9,0.3076923076923077
Nathan Knight,2023.0,8,24,16,0.3333333333333333
Naz Mitrou-Long,2018.0,1,1,0,1.0
Naz Mitrou-Long,2019.0,2,11,9,0.18181818181818182
Naz Mitrou-Long,2020.0,2,12,10,0.16666666666666666
Naz Reid,2020.0,32,97,65,0.32989690721649484
Naz Reid,2021.0,61,174,113,0.3505747126436782
Naz Reid,2022.0,60,173,113,0.3468208092485549
Naz Reid,2023.0,75,217,142,0.3456221198156682
Naz Reid,2024.0,89,218,129,0.40825688073394495
Nazr Mohammed,2005.0,1,2,1,0.5
Nazr Mohammed,2006.0,1,1,0,1.0
Nazr Mohammed,2008.0,0,1,1,0.0
Nazr Mohammed,2011.0,0,1,1,0.0
Nazr Mohammed,2012.0,0,1,1,0.0
Nazr Mohammed,2013.0,0,2,2,0.0
Nazr Mohammed,2015.0,0,1,1,0.0
Ndudi Ebi,2005.0,0,1,1,0.0
Nemanja Bjelica,2016.0,48,125,77,0.384
Nemanja Bjelica,2017.0,56,177,121,0.3163841807909605
Nemanja Bjelica,2018.0,80,190,110,0.42105263157894735
Nemanja Bjelica,2019.0,103,257,154,0.40077821011673154
Nemanja Bjelica,2020.0,134,321,187,0.4174454828660436
Nemanja Bjelica,2021.0,31,93,62,0.3333333333333333
Nemanja Bjelica,2022.0,57,157,100,0.3630573248407643
Nemanja Nedovic,2014.0,3,18,15,0.16666666666666666
Nenad Krstic,2005.0,0,2,2,0.0
Nenad Krstic,2006.0,1,4,3,0.25
Nenad Krstic,2007.0,0,1,1,0.0
Nenad Krstic,2008.0,0,2,2,0.0
Nenad Krstic,2010.0,1,5,4,0.2
Nene Hilario,2004.0,0,2,2,0.0
Nene Hilario,2005.0,0,2,2,0.0
Nene Hilario,2007.0,0,1,1,0.0
Nene Hilario,2008.0,0,1,1,0.0
Nene Hilario,2009.0,1,5,4,0.2
Nene Hilario,2010.0,0,2,2,0.0
Nene Hilario,2011.0,1,5,4,0.2
Nene Hilario,2012.0,0,4,4,0.0
Nene Hilario,2013.0,0,1,1,0.0
Nene Hilario,2014.0,1,5,4,0.2
Nene Hilario,2015.0,1,5,4,0.2
Nene Hilario,2016.0,0,3,3,0.0
Nene Hilario,2017.0,3,10,7,0.3
Nene Hilario,2018.0,0,2,2,0.0
Nene Hilario,2019.0,0,3,3,0.0
Nerlens Noel,2016.0,1,2,1,0.5
Nerlens Noel,2017.0,0,1,1,0.0
Nerlens Noel,2018.0,0,1,1,0.0
Nerlens Noel,2020.0,1,4,3,0.25
Nerlens Noel,2021.0,0,4,4,0.0
Nerlens Noel,2022.0,0,3,3,0.0
Nerlens Noel,2023.0,1,2,1,0.5
Nick Calathes,2014.0,19,61,42,0.3114754098360656
Nick Calathes,2015.0,17,56,39,0.30357142857142855
Nick Collison,2005.0,1,4,3,0.25
Nick Collison,2006.0,0,3,3,0.0
Nick Collison,2007.0,0,2,2,0.0
Nick Collison,2008.0,0,2,2,0.0
Nick Collison,2009.0,0,2,2,0.0
Nick Collison,2010.0,1,5,4,0.2
Nick Collison,2012.0,0,1,1,0.0
Nick Collison,2013.0,0,4,4,0.0
Nick Collison,2014.0,6,22,16,0.2727272727272727
Nick Collison,2015.0,16,60,44,0.26666666666666666
Nick Collison,2016.0,0,2,2,0.0
Nick Collison,2017.0,0,1,1,0.0
Nick Fazekas,2008.0,0,2,2,0.0
Nick Johnson,2015.0,6,28,22,0.21428571428571427
Nick Richards,2021.0,0,1,1,0.0
Nick Richards,2023.0,1,1,0,1.0
Nick Smith,2024.0,38,82,44,0.4634146341463415
Nick Van Exel,2004.0,46,150,104,0.30666666666666664
Nick Van Exel,2005.0,100,257,157,0.38910505836575876
Nick Van Exel,2006.0,58,164,106,0.35365853658536583
Nick Young,2008.0,40,102,62,0.39215686274509803
Nick Young,2009.0,56,164,108,0.34146341463414637
Nick Young,2010.0,69,170,101,0.40588235294117647
Nick Young,2011.0,105,271,166,0.3874538745387454
Nick Young,2012.0,120,315,195,0.38095238095238093
Nick Young,2013.0,75,210,135,0.35714285714285715
Nick Young,2014.0,135,350,215,0.38571428571428573
Nick Young,2015.0,83,225,142,0.3688888888888889
Nick Young,2016.0,77,237,160,0.32489451476793246
Nick Young,2017.0,170,419,249,0.40572792362768495
Nick Young,2018.0,137,373,236,0.3672922252010724
Nick Young,2019.0,3,8,5,0.375
Nickeil Alexander-Walker,2020.0,46,133,87,0.3458646616541353
Nickeil Alexander-Walker,2021.0,76,219,143,0.3470319634703196
Nickeil Alexander-Walker,2022.0,105,338,233,0.3106508875739645
Nickeil Alexander-Walker,2023.0,71,184,113,0.3858695652173913
Nickeil Alexander-Walker,2024.0,65,172,107,0.37790697674418605
Nico Mannion,2021.0,22,60,38,0.36666666666666664
Nicol?? Melli,2020.0,69,206,137,0.33495145631067963
Nicol?? Melli,2021.0,23,87,64,0.26436781609195403
Nicolas Batum,2009.0,64,172,108,0.37209302325581395
Nicolas Batum,2010.0,63,153,90,0.4117647058823529
Nicolas Batum,2011.0,125,368,243,0.33967391304347827
Nicolas Batum,2012.0,107,274,167,0.3905109489051095
Nicolas Batum,2013.0,162,437,275,0.3707093821510298
Nicolas Batum,2014.0,166,462,296,0.3593073593073593
Nicolas Batum,2015.0,113,348,235,0.32471264367816094
Nicolas Batum,2016.0,145,421,276,0.34441805225653205
Nicolas Batum,2017.0,135,405,270,0.3333333333333333
Nicolas Batum,2018.0,92,274,182,0.3357664233576642
Nicolas Batum,2019.0,116,298,182,0.38926174496644295
Nicolas Batum,2020.0,14,49,35,0.2857142857142857
Nicolas Batum,2021.0,138,343,205,0.40233236151603496
Nicolas Batum,2022.0,108,275,167,0.3927272727272727
Nicolas Batum,2023.0,130,334,204,0.38922155688622756
Nicolas Batum,2024.0,43,93,50,0.46236559139784944
Nicolas Brussino,2017.0,29,95,66,0.30526315789473685
Nicolas Brussino,2018.0,0,2,2,0.0
Nicolas Claxton,2020.0,1,7,6,0.14285714285714285
Nicolas Claxton,2021.0,1,5,4,0.2
Nicolas Claxton,2023.0,0,2,2,0.0
Nicolas Claxton,2024.0,1,3,2,0.3333333333333333
Nicolas Laprovittola,2017.0,10,27,17,0.37037037037037035
Nigel Hayes,2018.0,4,16,12,0.25
Nigel Williams-Goss,2020.0,2,7,5,0.2857142857142857
Nik Stauskas,2015.0,48,149,101,0.3221476510067114
Nik Stauskas,2016.0,106,325,219,0.3261538461538461
Nik Stauskas,2017.0,132,359,227,0.36768802228412256
Nik Stauskas,2018.0,40,100,60,0.4
Nik Stauskas,2019.0,70,188,118,0.3723404255319149
Nik Stauskas,2022.0,7,20,13,0.35
Nikola Jokic,2016.0,28,84,56,0.3333333333333333
Nikola Jokic,2017.0,45,139,94,0.3237410071942446
Nikola Jokic,2018.0,111,280,169,0.3964285714285714
Nikola Jokic,2019.0,105,326,221,0.3220858895705521
Nikola Jokic,2020.0,122,353,231,0.34560906515580736
Nikola Jokic,2021.0,112,290,178,0.38620689655172413
Nikola Jokic,2022.0,102,306,204,0.3333333333333333
Nikola Jokic,2023.0,92,225,133,0.4088888888888889
Nikola Jokic,2024.0,48,131,83,0.366412213740458
Nikola Jovic,2023.0,8,37,29,0.21621621621621623
Nikola Jovic,2024.0,19,45,26,0.4222222222222222
Nikola Mirotic,2015.0,106,343,237,0.30903790087463556
Nikola Mirotic,2016.0,135,346,211,0.3901734104046243
Nikola Mirotic,2017.0,139,412,273,0.33737864077669905
Nikola Mirotic,2018.0,157,409,252,0.38386308068459657
Nikola Mirotic,2019.0,138,394,256,0.350253807106599
Nikola Vucevic,2012.0,3,8,5,0.375
Nikola Vucevic,2013.0,0,3,3,0.0
Nikola Vucevic,2015.0,2,6,4,0.3333333333333333
Nikola Vucevic,2016.0,2,9,7,0.2222222222222222
Nikola Vucevic,2017.0,23,76,53,0.3026315789473684
Nikola Vucevic,2018.0,64,204,140,0.3137254901960784
Nikola Vucevic,2019.0,87,244,157,0.35655737704918034
Nikola Vucevic,2020.0,116,333,217,0.3483483483483483
Nikola Vucevic,2021.0,176,441,265,0.39909297052154197
Nikola Vucevic,2022.0,117,373,256,0.3136729222520107
Nikola Vucevic,2023.0,121,347,226,0.34870317002881845
Nikola Vucevic,2024.0,45,169,124,0.26627218934911245
Nikoloz Tskitishvili,2004.0,3,11,8,0.2727272727272727
Nikoloz Tskitishvili,2005.0,2,17,15,0.11764705882352941
Nikoloz Tskitishvili,2006.0,1,4,3,0.25
Noah Clowney,2023.0,3,8,5,0.375
Noah Clowney,2024.0,0,2,2,0.0
Noah Vonleh,2015.0,5,13,8,0.38461538461538464
Noah Vonleh,2016.0,11,46,35,0.2391304347826087
Noah Vonleh,2017.0,7,20,13,0.35
Noah Vonleh,2018.0,20,66,46,0.30303030303030304
Noah Vonleh,2019.0,46,137,91,0.3357664233576642
Noah Vonleh,2020.0,3,15,12,0.2
Noah Vonleh,2021.0,0,2,2,0.0
Noah Vonleh,2023.0,1,4,3,0.25
Noel Felix,2006.0,1,3,2,0.3333333333333333
Nolan Smith,2012.0,13,45,32,0.28888888888888886
Nolan Smith,2013.0,6,28,22,0.21428571428571427
Norman Powell,2016.0,43,115,72,0.3739130434782609
Norman Powell,2017.0,71,207,136,0.34299516908212563
Norman Powell,2018.0,54,193,139,0.27979274611398963
Norman Powell,2019.0,92,232,140,0.39655172413793105
Norman Powell,2020.0,131,325,194,0.40307692307692305
Norman Powell,2021.0,181,442,261,0.4095022624434389
Norman Powell,2022.0,107,257,150,0.4163424124513619
Norman Powell,2023.0,127,319,192,0.3981191222570533
Norman Powell,2024.0,88,199,111,0.44221105527638194
Norris Cole,2012.0,24,88,64,0.2727272727272727
Norris Cole,2013.0,52,130,78,0.4
Norris Cole,2014.0,75,214,139,0.35046728971962615
Norris Cole,2015.0,58,190,132,0.30526315789473685
Norris Cole,2016.0,33,102,69,0.3235294117647059
Norris Cole,2017.0,4,17,13,0.23529411764705882
Norvel Pelle,2020.0,0,1,1,0.0
O.J. Mayo,2009.0,145,378,233,0.3835978835978836
O.J. Mayo,2010.0,136,355,219,0.38309859154929576
O.J. Mayo,2011.0,116,313,197,0.3706070287539936
O.J. Mayo,2012.0,107,299,192,0.35785953177257523
O.J. Mayo,2013.0,142,349,207,0.4068767908309456
O.J. Mayo,2014.0,84,227,143,0.3700440528634361
O.J. Mayo,2015.0,105,296,191,0.3547297297297297
O.J. Mayo,2016.0,52,162,110,0.32098765432098764
OG Anunoby,2018.0,86,226,140,0.3805309734513274
OG Anunoby,2019.0,67,202,135,0.3316831683168317
OG Anunoby,2020.0,106,269,163,0.3940520446096654
OG Anunoby,2021.0,104,261,157,0.39846743295019155
OG Anunoby,2022.0,129,358,229,0.36033519553072624
OG Anunoby,2023.0,142,367,225,0.3869209809264305
OG Anunoby,2024.0,86,227,141,0.3788546255506608
Obi Toppin,2021.0,29,94,65,0.30851063829787234
Obi Toppin,2022.0,52,169,117,0.3076923076923077
Obi Toppin,2023.0,98,290,192,0.33793103448275863
Obi Toppin,2024.0,62,157,95,0.39490445859872614
Obinna Ekezie,2005.0,0,1,1,0.0
Ochai Agbaji,2023.0,81,228,147,0.35526315789473684
Ochai Agbaji,2024.0,45,137,92,0.3284671532846715
Okaro White,2017.0,12,34,22,0.35294117647058826
Okaro White,2018.0,4,11,7,0.36363636363636365
Okaro White,2019.0,0,2,2,0.0
Oleksiy Pecherov,2008.0,17,60,43,0.2833333333333333
Oleksiy Pecherov,2009.0,14,43,29,0.32558139534883723
Oleksiy Pecherov,2010.0,14,52,38,0.2692307692307692
Oliver Lafayette,2010.0,1,2,1,0.5
Oliver Miller,2004.0,0,1,1,0.0
Olivier Sarr ,2022.0,13,29,16,0.4482758620689655
Olivier Sarr ,2023.0,1,8,7,0.125
Olivier Sarr ,2024.0,2,5,3,0.4
Olivier-Maxence Prosper,2024.0,8,31,23,0.25806451612903225
Omar Cook,2004.0,0,1,1,0.0
Omar Cook,2005.0,0,4,4,0.0
Omari Johnson,2018.0,4,12,8,0.3333333333333333
Omari Spellman,2019.0,44,128,84,0.34375
Omari Spellman,2020.0,43,110,67,0.39090909090909093
Omer Asik,2013.0,0,1,1,0.0
Omer Yurtseven,2022.0,1,13,12,0.07692307692307693
Omer Yurtseven,2023.0,3,9,6,0.3333333333333333
Omer Yurtseven,2024.0,3,15,12,0.2
Omri Casspi,2010.0,75,203,128,0.3694581280788177
Omri Casspi,2011.0,92,247,155,0.3724696356275304
Omri Casspi,2012.0,53,168,115,0.31547619047619047
Omri Casspi,2013.0,25,76,51,0.32894736842105265
Omri Casspi,2014.0,61,176,115,0.3465909090909091
Omri Casspi,2015.0,35,87,52,0.40229885057471265
Omri Casspi,2016.0,112,274,162,0.40875912408759124
Omri Casspi,2017.0,15,43,28,0.3488372093023256
Omri Casspi,2018.0,10,22,12,0.45454545454545453
Omri Casspi,2019.0,15,43,28,0.3488372093023256
Onuralp Bitim,2023.0,1,3,2,0.3333333333333333
Onyeka Okongwu,2021.0,0,5,5,0.0
Onyeka Okongwu,2023.0,5,14,9,0.35714285714285715
Onyeka Okongwu,2024.0,14,50,36,0.28
Orien Greene,2006.0,9,40,31,0.225
Orien Greene,2007.0,2,11,9,0.18181818181818182
Orien Greene,2008.0,0,1,1,0.0
Orlando Johnson,2013.0,37,97,60,0.38144329896907214
Orlando Johnson,2014.0,9,47,38,0.19148936170212766
Orlando Johnson,2016.0,2,10,8,0.2
Orlando Robinson,2023.0,0,6,6,0.0
Orlando Robinson,2024.0,7,12,5,0.5833333333333334
Oscar Tshiebwe,2024.0,1,1,0,1.0
Oshae Brissett,2020.0,3,15,12,0.2
Oshae Brissett,2021.0,38,89,51,0.42696629213483145
Oshae Brissett,2022.0,83,237,154,0.350210970464135
Oshae Brissett,2023.0,48,155,107,0.3096774193548387
Oshae Brissett,2024.0,10,34,24,0.29411764705882354
Othyus Jeffers,2011.0,1,4,3,0.25
Othyus Jeffers,2014.0,0,2,2,0.0
Otto Porter,2014.0,4,22,18,0.18181818181818182
Otto Porter,2015.0,47,136,89,0.34558823529411764
Otto Porter,2016.0,98,267,169,0.36704119850187267
Otto Porter,2017.0,159,381,222,0.41732283464566927
Otto Porter,2018.0,143,325,182,0.44
Otto Porter,2019.0,104,256,152,0.40625
Otto Porter,2020.0,24,62,38,0.3870967741935484
Otto Porter,2021.0,39,104,65,0.375
Otto Porter,2022.0,99,263,164,0.376425855513308
Otto Porter,2023.0,6,17,11,0.35294117647058826
Otto Porter,2024.0,8,23,15,0.34782608695652173
Ousmane Dieng,2023.0,26,98,72,0.2653061224489796
Ousmane Dieng,2024.0,16,52,36,0.3076923076923077
P.J. Brown,2004.0,0,1,1,0.0
P.J. Brown,2007.0,0,2,2,0.0
P.J. Brown,2008.0,0,2,2,0.0
P.J. Hairston,2015.0,49,163,114,0.3006134969325153
P.J. Hairston,2016.0,71,244,173,0.29098360655737704
P.J. Tucker,2013.0,22,70,48,0.3142857142857143
P.J. Tucker,2014.0,74,191,117,0.387434554973822
P.J. Tucker,2015.0,87,252,165,0.34523809523809523
P.J. Tucker,2016.0,68,206,138,0.3300970873786408
P.J. Tucker,2017.0,79,224,145,0.35267857142857145
P.J. Tucker,2018.0,150,385,235,0.38961038961038963
P.J. Tucker,2019.0,172,444,272,0.38738738738738737
P.J. Tucker,2020.0,132,366,234,0.36065573770491804
P.J. Tucker,2021.0,59,178,119,0.33146067415730335
P.J. Tucker,2022.0,103,244,141,0.42213114754098363
P.J. Tucker,2023.0,69,180,111,0.38333333333333336
P.J. Tucker,2024.0,5,16,11,0.3125
PJ Dozier,2019.0,2,8,6,0.25
PJ Dozier,2020.0,19,57,38,0.3333333333333333
PJ Dozier,2021.0,47,149,102,0.31543624161073824
PJ Dozier,2022.0,15,48,33,0.3125
PJ Dozier,2023.0,4,20,16,0.2
PJ Washington,2020.0,86,230,144,0.3739130434782609
PJ Washington,2021.0,114,295,181,0.3864406779661017
PJ Washington,2022.0,113,306,193,0.369281045751634
PJ Washington,2023.0,149,428,279,0.34813084112149534
PJ Washington,2024.0,72,207,135,0.34782608695652173
Pablo Prigioni,2013.0,66,164,98,0.4024390243902439
Pablo Prigioni,2014.0,65,140,75,0.4642857142857143
Pablo Prigioni,2015.0,69,207,138,0.3333333333333333
Pablo Prigioni,2016.0,28,97,69,0.28865979381443296
Paolo Banchero,2023.0,85,285,200,0.2982456140350877
Paolo Banchero,2024.0,66,189,123,0.3492063492063492
Pape Sy,2011.0,0,1,1,0.0
Paris Bass,2022.0,0,2,2,0.0
Pascal Siakam,2017.0,1,7,6,0.14285714285714285
Pascal Siakam,2018.0,32,136,104,0.23529411764705882
Pascal Siakam,2019.0,108,318,210,0.33962264150943394
Pascal Siakam,2020.0,141,418,277,0.3373205741626794
Pascal Siakam,2021.0,73,246,173,0.2967479674796748
Pascal Siakam,2022.0,79,235,156,0.33617021276595743
Pascal Siakam,2023.0,93,287,194,0.3240418118466899
Pascal Siakam,2024.0,51,158,107,0.3227848101265823
Pat Burke,2006.0,3,9,6,0.3333333333333333
Pat Burke,2007.0,6,22,16,0.2727272727272727
Pat Connaughton,2016.0,7,24,17,0.2916666666666667
Pat Connaughton,2017.0,17,39,22,0.4358974358974359
Pat Connaughton,2018.0,76,220,144,0.34545454545454546
Pat Connaughton,2019.0,81,242,161,0.3347107438016529
Pat Connaughton,2020.0,63,189,126,0.3333333333333333
Pat Connaughton,2021.0,138,367,229,0.3760217983651226
Pat Connaughton,2022.0,171,434,263,0.39400921658986177
Pat Connaughton,2023.0,120,345,225,0.34782608695652173
Pat Connaughton,2024.0,48,126,78,0.38095238095238093
Pat Garrity,2005.0,49,147,98,0.3333333333333333
Pat Garrity,2006.0,50,129,79,0.3875968992248062
Pat Garrity,2007.0,11,32,21,0.34375
Pat Garrity,2008.0,8,38,30,0.21052631578947367
Patricio Garino,2017.0,0,5,5,0.0
Patrick Baldwin,2023.0,32,87,55,0.367816091954023
Patrick Baldwin,2024.0,9,17,8,0.5294117647058824
Patrick Beverley,2013.0,44,120,76,0.36666666666666664
Patrick Beverley,2014.0,99,277,178,0.3574007220216607
Patrick Beverley,2015.0,115,323,208,0.3560371517027864
Patrick Beverley,2016.0,127,324,197,0.39197530864197533
Patrick Beverley,2017.0,131,339,208,0.3864306784660767
Patrick Beverley,2018.0,24,60,36,0.4
Patrick Beverley,2019.0,125,311,186,0.40192926045016075
Patrick Beverley,2020.0,88,228,140,0.38596491228070173
Patrick Beverley,2021.0,69,178,109,0.38764044943820225
Patrick Beverley,2022.0,92,268,176,0.34328358208955223
Patrick Beverley,2023.0,80,239,159,0.33472803347280333
Patrick Beverley,2024.0,28,92,64,0.30434782608695654
Patrick Christopher,2015.0,0,4,4,0.0
Patrick Ewing,2011.0,1,3,2,0.3333333333333333
Patrick McCaw,2017.0,49,146,97,0.3356164383561644
Patrick McCaw,2018.0,19,81,62,0.2345679012345679
Patrick McCaw,2019.0,10,31,21,0.3225806451612903
Patrick McCaw,2020.0,23,71,48,0.323943661971831
Patrick O'Bryant,2009.0,0,2,2,0.0
Patrick O'Bryant,2010.0,0,1,1,0.0
Patrick Patterson,2011.0,0,2,2,0.0
Patrick Patterson,2012.0,0,3,3,0.0
Patrick Patterson,2013.0,51,132,81,0.38636363636363635
Patrick Patterson,2014.0,62,169,107,0.3668639053254438
Patrick Patterson,2015.0,112,298,186,0.37583892617449666
Patrick Patterson,2016.0,127,363,236,0.349862258953168
Patrick Patterson,2017.0,102,279,177,0.3655913978494624
Patrick Patterson,2018.0,68,175,107,0.38857142857142857
Patrick Patterson,2019.0,46,137,91,0.3357664233576642
Patrick Patterson,2020.0,70,175,105,0.4
Patrick Patterson,2021.0,40,112,72,0.35714285714285715
Patrick Williams,2021.0,54,138,84,0.391304347826087
Patrick Williams,2022.0,22,50,28,0.44
Patrick Williams,2023.0,115,277,162,0.4151624548736462
Patrick Williams,2024.0,59,148,89,0.39864864864864863
Patty Mills,2010.0,3,5,2,0.6
Patty Mills,2011.0,47,134,87,0.35074626865671643
Patty Mills,2012.0,27,61,34,0.4426229508196721
Patty Mills,2013.0,54,137,83,0.39416058394160586
Patty Mills,2014.0,167,397,230,0.42065491183879095
Patty Mills,2015.0,78,210,132,0.37142857142857144
Patty Mills,2016.0,136,356,220,0.38202247191011235
Patty Mills,2017.0,179,445,266,0.40224719101123596
Patty Mills,2018.0,167,449,282,0.37193763919821826
Patty Mills,2019.0,162,426,264,0.38028169014084506
Patty Mills,2020.0,154,403,249,0.38213399503722084
Patty Mills,2021.0,164,436,272,0.3761467889908257
Patty Mills,2022.0,234,581,347,0.4027538726333907
Patty Mills,2023.0,49,136,87,0.3602941176470588
Patty Mills,2024.0,13,29,16,0.4482758620689655
Pau Gasol,2004.0,4,15,11,0.26666666666666666
Pau Gasol,2005.0,2,7,5,0.2857142857142857
Pau Gasol,2006.0,3,13,10,0.23076923076923078
Pau Gasol,2007.0,3,11,8,0.2727272727272727
Pau Gasol,2008.0,4,16,12,0.25
Pau Gasol,2009.0,1,2,1,0.5
Pau Gasol,2010.0,0,8,8,0.0
Pau Gasol,2011.0,2,5,3,0.4
Pau Gasol,2012.0,9,32,23,0.28125
Pau Gasol,2013.0,8,28,20,0.2857142857142857
Pau Gasol,2014.0,4,14,10,0.2857142857142857
Pau Gasol,2015.0,12,30,18,0.4
Pau Gasol,2016.0,24,69,45,0.34782608695652173
Pau Gasol,2017.0,62,122,60,0.5081967213114754
Pau Gasol,2018.0,44,123,79,0.35772357723577236
Pau Gasol,2019.0,6,13,7,0.46153846153846156
Paul Davis,2009.0,0,1,1,0.0
Paul George,2011.0,44,151,107,0.2913907284768212
Paul George,2012.0,101,275,174,0.36727272727272725
Paul George,2013.0,204,573,369,0.35602094240837695
Paul George,2014.0,234,629,395,0.37201907790143085
Paul George,2015.0,9,22,13,0.4090909090909091
Paul George,2016.0,228,609,381,0.37438423645320196
Paul George,2017.0,213,537,324,0.39664804469273746
Paul George,2018.0,263,661,398,0.3978819969742814
Paul George,2019.0,307,804,497,0.3818407960199005
Paul George,2020.0,194,492,298,0.3943089430894309
Paul George,2021.0,222,568,346,0.3908450704225352
Paul George,2022.0,91,257,166,0.3540856031128405
Paul George,2023.0,158,426,268,0.37089201877934275
Paul George,2024.0,148,354,206,0.4180790960451977
Paul Millsap,2007.0,1,4,3,0.25
Paul Millsap,2008.0,0,5,5,0.0
Paul Millsap,2009.0,0,4,4,0.0
Paul Millsap,2010.0,1,11,10,0.09090909090909091
Paul Millsap,2011.0,9,23,14,0.391304347826087
Paul Millsap,2012.0,7,34,27,0.20588235294117646
Paul Millsap,2013.0,13,39,26,0.3333333333333333
Paul Millsap,2014.0,85,239,154,0.35564853556485354
Paul Millsap,2015.0,92,265,173,0.3471698113207547
Paul Millsap,2016.0,82,265,183,0.30943396226415093
Paul Millsap,2017.0,78,258,180,0.3023255813953488
Paul Millsap,2018.0,39,113,74,0.34513274336283184
Paul Millsap,2019.0,70,197,127,0.3553299492385787
Paul Millsap,2020.0,69,168,99,0.4107142857142857
Paul Millsap,2021.0,55,166,111,0.3313253012048193
Paul Millsap,2022.0,8,35,27,0.22857142857142856
Paul Pierce,2004.0,119,398,279,0.2989949748743719
Paul Pierce,2005.0,115,319,204,0.3605015673981191
Paul Pierce,2006.0,111,314,203,0.3535031847133758
Paul Pierce,2007.0,107,275,168,0.3890909090909091
Paul Pierce,2008.0,186,484,298,0.384297520661157
Paul Pierce,2009.0,138,361,223,0.38227146814404434
Paul Pierce,2010.0,149,365,216,0.40821917808219177
Paul Pierce,2011.0,132,344,212,0.38372093023255816
Paul Pierce,2012.0,127,360,233,0.3527777777777778
Paul Pierce,2013.0,156,423,267,0.36879432624113473
Paul Pierce,2014.0,131,353,222,0.37110481586402266
Paul Pierce,2015.0,151,366,215,0.412568306010929
Paul Pierce,2016.0,76,247,171,0.3076923076923077
Paul Pierce,2017.0,19,53,34,0.3584905660377358
Paul Reed,2021.0,0,6,6,0.0
Paul Reed,2022.0,4,11,7,0.36363636363636365
Paul Reed,2023.0,1,6,5,0.16666666666666666
Paul Reed,2024.0,9,25,16,0.36
Paul Shirley,2004.0,0,1,1,0.0
Paul Watson,2020.0,4,12,8,0.3333333333333333
Paul Watson,2021.0,30,64,34,0.46875
Paul Watson,2022.0,6,26,20,0.23076923076923078
Paul Zipser,2017.0,39,115,76,0.3391304347826087
Paul Zipser,2018.0,37,110,73,0.33636363636363636
Payton Pritchard,2021.0,104,258,154,0.40310077519379844
Payton Pritchard,2022.0,125,317,192,0.3943217665615142
Payton Pritchard,2023.0,60,164,104,0.36585365853658536
Payton Pritchard,2024.0,78,205,127,0.3804878048780488
Peja Stojakovic,2004.0,263,627,364,0.4194577352472089
Peja Stojakovic,2005.0,185,463,278,0.39956803455723544
Peja Stojakovic,2006.0,162,407,245,0.39803439803439805
Peja Stojakovic,2007.0,34,84,50,0.40476190476190477
Peja Stojakovic,2008.0,259,575,316,0.4504347826086956
Peja Stojakovic,2009.0,153,410,257,0.37317073170731707
Peja Stojakovic,2010.0,132,352,220,0.375
Peja Stojakovic,2011.0,86,213,127,0.40375586854460094
Pero Antic,2014.0,59,196,137,0.3010204081632653
Pero Antic,2015.0,63,205,142,0.3073170731707317
Perry Jones,2013.0,0,2,2,0.0
Perry Jones,2014.0,25,71,46,0.352112676056338
Perry Jones,2015.0,14,60,46,0.23333333333333334
Petr Cornelie,2022.0,1,8,7,0.125
Peyton Siva,2014.0,7,25,18,0.28
Peyton Watson,2023.0,7,16,9,0.4375
Peyton Watson,2024.0,30,94,64,0.3191489361702128
Phil Pressey,2014.0,28,106,78,0.2641509433962264
Phil Pressey,2015.0,16,66,50,0.24242424242424243
Phil Pressey,2016.0,4,18,14,0.2222222222222222
Pierre Jackson,2017.0,3,11,8,0.2727272727272727
Pops Mensah-Bonsu,2009.0,0,2,2,0.0
Precious Achiuwa,2021.0,0,1,1,0.0
Precious Achiuwa,2022.0,61,172,111,0.3546511627906977
Precious Achiuwa,2023.0,29,108,79,0.26851851851851855
Precious Achiuwa,2024.0,14,53,39,0.2641509433962264
Predrag Drobnjak,2004.0,11,36,25,0.3055555555555556
Predrag Drobnjak,2005.0,25,71,46,0.352112676056338
Primoz Brezec,2006.0,0,2,2,0.0
Primoz Brezec,2007.0,1,3,2,0.3333333333333333
Quentin Grimes,2022.0,72,189,117,0.38095238095238093
Quentin Grimes,2023.0,166,444,278,0.3738738738738739
Quentin Grimes,2024.0,74,200,126,0.37
Quentin Richardson,2004.0,120,341,221,0.3519061583577713
Quentin Richardson,2005.0,258,713,455,0.36185133239831696
Quentin Richardson,2006.0,64,188,124,0.3404255319148936
Quentin Richardson,2007.0,97,258,161,0.375968992248062
Quentin Richardson,2008.0,66,207,141,0.3188405797101449
Quentin Richardson,2009.0,120,329,209,0.364741641337386
Quentin Richardson,2010.0,151,380,229,0.3973684210526316
Quentin Richardson,2011.0,47,156,109,0.30128205128205127
Quentin Richardson,2012.0,44,128,84,0.34375
Quentin Richardson,2013.0,3,9,6,0.3333333333333333
Quenton Jackson,2023.0,1,12,11,0.08333333333333333
Quincy Acy,2013.0,1,2,1,0.5
Quincy Acy,2014.0,4,15,11,0.26666666666666666
Quincy Acy,2015.0,18,60,42,0.3
Quincy Acy,2016.0,19,49,30,0.3877551020408163
Quincy Acy,2017.0,36,87,51,0.41379310344827586
Quincy Acy,2018.0,102,292,190,0.3493150684931507
Quincy Acy,2019.0,2,15,13,0.13333333333333333
Quincy Douby,2007.0,12,50,38,0.24
Quincy Douby,2008.0,42,122,80,0.3442622950819672
Quincy Douby,2009.0,14,46,32,0.30434782608695654
Quincy Lewis,2004.0,2,5,3,0.4
Quincy Miller,2013.0,0,1,1,0.0
Quincy Miller,2014.0,30,94,64,0.3191489361702128
Quincy Miller,2015.0,3,18,15,0.16666666666666666
Quincy Pondexter,2011.0,18,53,35,0.33962264150943394
Quincy Pondexter,2012.0,24,77,53,0.3116883116883117
Quincy Pondexter,2013.0,84,205,121,0.4097560975609756
Quincy Pondexter,2014.0,11,34,23,0.3235294117647059
Quincy Pondexter,2015.0,94,254,160,0.3700787401574803
Quincy Pondexter,2018.0,3,22,19,0.13636363636363635
Quincy Pondexter,2019.0,6,19,13,0.3157894736842105
Quinn Cook,2017.0,11,26,15,0.4230769230769231
Quinn Cook,2018.0,53,135,82,0.3925925925925926
Quinn Cook,2019.0,92,234,142,0.39316239316239315
Quinn Cook,2020.0,33,89,56,0.3707865168539326
Quinn Cook,2021.0,11,26,15,0.4230769230769231
Quinndary Weatherspoon,2020.0,1,5,4,0.2
Quinndary Weatherspoon,2021.0,1,6,5,0.16666666666666666
Quinndary Weatherspoon,2022.0,1,5,4,0.2
Quinton Ross,2005.0,1,4,3,0.25
Quinton Ross,2006.0,0,7,7,0.0
Quinton Ross,2007.0,2,10,8,0.2
Quinton Ross,2008.0,9,21,12,0.42857142857142855
Quinton Ross,2009.0,33,88,55,0.375
Quinton Ross,2010.0,4,21,17,0.19047619047619047
Quinton Ross,2011.0,0,3,3,0.0
Qyntel Woods,2004.0,10,29,19,0.3448275862068966
Qyntel Woods,2006.0,22,60,38,0.36666666666666664
R.J. Hampton,2021.0,27,87,60,0.3103448275862069
R.J. Hampton,2022.0,64,183,119,0.34972677595628415
R.J. Hampton,2023.0,41,116,75,0.35344827586206895
R.J. Hampton,2024.0,1,8,7,0.125
R.J. Hunter,2016.0,20,68,48,0.29411764705882354
R.J. Hunter,2017.0,0,1,1,0.0
R.J. Hunter,2018.0,3,14,11,0.21428571428571427
R.J. Hunter,2019.0,4,10,6,0.4
RJ Barrett,2020.0,63,197,134,0.3197969543147208
RJ Barrett,2021.0,132,337,205,0.3916913946587537
RJ Barrett,2022.0,138,404,266,0.3415841584158416
RJ Barrett,2023.0,141,451,310,0.31263858093126384
RJ Barrett,2024.0,61,180,119,0.3388888888888889
RJ Nembhard,2022.0,0,2,2,0.0
Raef LaFrentz,2004.0,8,39,31,0.20512820512820512
Raef LaFrentz,2005.0,90,241,151,0.37344398340248963
Raef LaFrentz,2006.0,112,286,174,0.3916083916083916
Raef LaFrentz,2007.0,2,23,21,0.08695652173913043
Raef LaFrentz,2008.0,0,4,4,0.0
Rafael Araujo,2005.0,1,3,2,0.3333333333333333
Rafael Araujo,2006.0,0,1,1,0.0
Rafer Alston,2004.0,172,481,309,0.3575883575883576
Rafer Alston,2005.0,139,389,250,0.35732647814910024
Rafer Alston,2006.0,102,312,210,0.3269230769230769
Rafer Alston,2007.0,208,579,371,0.3592400690846287
Rafer Alston,2008.0,154,432,278,0.35648148148148145
Rafer Alston,2009.0,148,444,296,0.3333333333333333
Rafer Alston,2010.0,58,168,110,0.34523809523809523
RaiQuan Gray,2023.0,2,5,3,0.4
Raja Bell,2004.0,62,166,104,0.37349397590361444
Raja Bell,2005.0,54,134,80,0.40298507462686567
Raja Bell,2006.0,237,532,295,0.44548872180451127
Raja Bell,2007.0,225,541,316,0.41589648798521256
Raja Bell,2008.0,189,459,270,0.4117647058823529
Raja Bell,2009.0,114,271,157,0.42066420664206644
Raja Bell,2010.0,12,27,15,0.4444444444444444
Raja Bell,2011.0,68,193,125,0.35233160621761656
Raja Bell,2012.0,34,87,53,0.39080459770114945
Rajon Rondo,2007.0,6,29,23,0.20689655172413793
Rajon Rondo,2008.0,10,39,29,0.2564102564102564
Rajon Rondo,2009.0,21,72,51,0.2916666666666667
Rajon Rondo,2010.0,26,104,78,0.25
Rajon Rondo,2011.0,10,46,36,0.21739130434782608
Rajon Rondo,2012.0,18,72,54,0.25
Rajon Rondo,2013.0,12,50,38,0.24
Rajon Rondo,2014.0,26,90,64,0.28888888888888886
Rajon Rondo,2015.0,28,88,60,0.3181818181818182
Rajon Rondo,2016.0,62,170,108,0.36470588235294116
Rajon Rondo,2017.0,50,139,89,0.3597122302158273
Rajon Rondo,2018.0,58,169,111,0.3431952662721893
Rajon Rondo,2019.0,51,142,91,0.3591549295774648
Rajon Rondo,2020.0,61,175,114,0.3485714285714286
Rajon Rondo,2021.0,47,117,70,0.4017094017094017
Rajon Rondo,2022.0,31,90,59,0.34444444444444444
Ramon Sessions,2008.0,3,7,4,0.42857142857142855
Ramon Sessions,2009.0,6,34,28,0.17647058823529413
Ramon Sessions,2010.0,1,15,14,0.06666666666666667
Ramon Sessions,2011.0,3,15,12,0.2
Ramon Sessions,2012.0,47,122,75,0.38524590163934425
Ramon Sessions,2013.0,33,107,74,0.308411214953271
Ramon Sessions,2014.0,35,124,89,0.28225806451612906
Ramon Sessions,2015.0,29,85,56,0.3411764705882353
Ramon Sessions,2016.0,36,111,75,0.32432432432432434
Ramon Sessions,2017.0,21,62,41,0.3387096774193548
Ramon Sessions,2018.0,8,26,18,0.3076923076923077
Randy Foye,2007.0,68,185,117,0.3675675675675676
Randy Foye,2008.0,61,148,87,0.41216216216216217
Randy Foye,2009.0,111,308,197,0.36038961038961037
Randy Foye,2010.0,63,182,119,0.34615384615384615
Randy Foye,2011.0,71,217,146,0.3271889400921659
Randy Foye,2012.0,141,361,220,0.39058171745152354
Randy Foye,2013.0,178,434,256,0.41013824884792627
Randy Foye,2014.0,189,498,309,0.3795180722891566
Randy Foye,2015.0,94,263,169,0.3574144486692015
Randy Foye,2016.0,83,276,193,0.3007246376811594
Randy Foye,2017.0,63,199,136,0.3165829145728643
Randy Livingston,2004.0,0,3,3,0.0
Randy Livingston,2005.0,5,8,3,0.625
Rashad McCants,2006.0,67,180,113,0.37222222222222223
Rashad McCants,2007.0,20,75,55,0.26666666666666666
Rashad McCants,2008.0,142,349,207,0.4068767908309456
Rashad McCants,2009.0,63,189,126,0.3333333333333333
Rashad Vaughn,2016.0,43,147,104,0.2925170068027211
Rashad Vaughn,2017.0,28,83,55,0.3373493975903614
Rashad Vaughn,2018.0,14,37,23,0.3783783783783784
Rashard Lewis,2004.0,145,386,241,0.3756476683937824
Rashard Lewis,2005.0,178,457,279,0.38949671772428884
Rashard Lewis,2006.0,142,370,228,0.3837837837837838
Rashard Lewis,2007.0,151,387,236,0.39018087855297157
Rashard Lewis,2008.0,247,621,374,0.3977455716586151
Rashard Lewis,2009.0,272,686,414,0.3965014577259475
Rashard Lewis,2010.0,196,498,302,0.39357429718875503
Rashard Lewis,2011.0,87,244,157,0.35655737704918034
Rashard Lewis,2012.0,16,67,51,0.23880597014925373
Rashard Lewis,2013.0,51,135,84,0.37777777777777777
Rashard Lewis,2014.0,68,193,125,0.35233160621761656
Rasheed Wallace,2004.0,99,318,219,0.3113207547169811
Rasheed Wallace,2005.0,104,322,218,0.32298136645962733
Rasheed Wallace,2006.0,187,513,326,0.3645224171539961
Rasheed Wallace,2007.0,129,368,239,0.35054347826086957
Rasheed Wallace,2008.0,136,390,254,0.3487179487179487
Rasheed Wallace,2009.0,117,327,210,0.3577981651376147
Rasheed Wallace,2010.0,101,345,244,0.2927536231884058
Rasheed Wallace,2013.0,22,69,47,0.3188405797101449
Rasho Nesterovic,2004.0,0,1,1,0.0
Rasho Nesterovic,2006.0,1,3,2,0.3333333333333333
Rasho Nesterovic,2007.0,0,1,1,0.0
Rasho Nesterovic,2008.0,1,3,2,0.3333333333333333
Rasho Nesterovic,2009.0,0,1,1,0.0
Rasual Butler,2004.0,53,117,64,0.452991452991453
Rasual Butler,2005.0,68,183,115,0.37158469945355194
Rasual Butler,2006.0,92,242,150,0.38016528925619836
Rasual Butler,2007.0,134,363,229,0.3691460055096419
Rasual Butler,2008.0,44,133,89,0.3308270676691729
Rasual Butler,2009.0,150,378,228,0.3968253968253968
Rasual Butler,2010.0,145,432,287,0.33564814814814814
Rasual Butler,2011.0,47,137,90,0.34306569343065696
Rasual Butler,2012.0,21,77,56,0.2727272727272727
Rasual Butler,2014.0,31,74,43,0.4189189189189189
Rasual Butler,2015.0,91,236,145,0.3855932203389831
Rasual Butler,2016.0,15,49,34,0.30612244897959184
Raul Lopez,2004.0,25,85,60,0.29411764705882354
Raul Lopez,2005.0,20,45,25,0.4444444444444444
Raul Neto,2016.0,64,162,98,0.3950617283950617
Raul Neto,2017.0,13,37,24,0.35135135135135137
Raul Neto,2018.0,21,54,33,0.3888888888888889
Raul Neto,2019.0,20,61,41,0.32786885245901637
Raul Neto,2020.0,36,93,57,0.3870967741935484
Raul Neto,2021.0,70,184,114,0.3804347826086957
Raul Neto,2022.0,35,120,85,0.2916666666666667
Raul Neto,2023.0,12,43,31,0.27906976744186046
Rawle Alkins,2019.0,3,12,9,0.25
Rawle Marshall,2006.0,1,3,2,0.3333333333333333
Rawle Marshall,2007.0,4,18,14,0.2222222222222222
Ray Allen,2004.0,148,378,230,0.3915343915343915
Ray Allen,2005.0,240,638,398,0.3761755485893417
Ray Allen,2006.0,269,653,384,0.4119448698315467
Ray Allen,2007.0,165,443,278,0.3724604966139955
Ray Allen,2008.0,235,591,356,0.3976311336717428
Ray Allen,2009.0,234,586,352,0.3993174061433447
Ray Allen,2010.0,201,544,343,0.3694852941176471
Ray Allen,2011.0,200,434,234,0.4608294930875576
Ray Allen,2012.0,134,326,192,0.4110429447852761
Ray Allen,2013.0,178,428,250,0.4158878504672897
Ray Allen,2014.0,149,394,245,0.37817258883248733
Ray McCallum,2014.0,22,59,37,0.3728813559322034
Ray McCallum,2015.0,34,111,77,0.3063063063063063
Ray McCallum,2016.0,15,42,27,0.35714285714285715
Ray Spalding,2019.0,0,3,3,0.0
Ray Spalding,2021.0,0,1,1,0.0
Rayan Rupert,2024.0,7,16,9,0.4375
Rayjon Tucker,2020.0,4,20,16,0.2
Rayjon Tucker,2021.0,2,7,5,0.2857142857142857
Rayjon Tucker,2022.0,4,6,2,0.6666666666666666
Raymond Felton,2006.0,96,268,172,0.3582089552238806
Raymond Felton,2007.0,103,312,209,0.3301282051282051
Raymond Felton,2008.0,56,200,144,0.28
Raymond Felton,2009.0,59,207,148,0.28502415458937197
Raymond Felton,2010.0,64,169,105,0.378698224852071
Raymond Felton,2011.0,120,345,225,0.34782608695652173
Raymond Felton,2012.0,62,203,141,0.3054187192118227
Raymond Felton,2013.0,102,286,184,0.35664335664335667
Raymond Felton,2014.0,62,195,133,0.31794871794871793
Raymond Felton,2015.0,10,38,28,0.2631578947368421
Raymond Felton,2016.0,64,227,163,0.28193832599118945
Raymond Felton,2017.0,50,153,103,0.32679738562091504
Raymond Felton,2018.0,88,244,156,0.36065573770491804
Raymond Felton,2019.0,22,69,47,0.3188405797101449
Reece Gaines,2004.0,3,10,7,0.3
Reece Gaines,2005.0,4,14,10,0.2857142857142857
Reece Gaines,2006.0,0,2,2,0.0
Reggie Bullock,2014.0,22,73,51,0.3013698630136986
Reggie Bullock,2015.0,15,46,31,0.32608695652173914
Reggie Bullock,2016.0,24,56,32,0.42857142857142855
Reggie Bullock,2017.0,28,73,45,0.3835616438356164
Reggie Bullock,2018.0,125,281,156,0.44483985765124556
Reggie Bullock,2019.0,148,393,245,0.37659033078880405
Reggie Bullock,2020.0,37,111,74,0.3333333333333333
Reggie Bullock,2021.0,173,427,254,0.405152224824356
Reggie Bullock,2022.0,193,523,330,0.3690248565965583
Reggie Bullock,2023.0,151,397,246,0.380352644836272
Reggie Bullock,2024.0,11,27,16,0.4074074074074074
Reggie Evans,2004.0,0,3,3,0.0
Reggie Evans,2005.0,0,2,2,0.0
Reggie Evans,2006.0,0,3,3,0.0
Reggie Evans,2008.0,1,1,0,1.0
Reggie Evans,2009.0,0,1,1,0.0
Reggie Evans,2011.0,0,1,1,0.0
Reggie Evans,2015.0,0,2,2,0.0
Reggie Hearn,2018.0,1,2,1,0.5
Reggie Jackson,2012.0,13,62,49,0.20967741935483872
Reggie Jackson,2013.0,37,147,110,0.25170068027210885
Reggie Jackson,2014.0,104,298,194,0.348993288590604
Reggie Jackson,2015.0,72,241,169,0.2987551867219917
Reggie Jackson,2016.0,121,352,231,0.34375
Reggie Jackson,2017.0,66,184,118,0.358695652173913
Reggie Jackson,2018.0,52,169,117,0.3076923076923077
Reggie Jackson,2019.0,183,492,309,0.3719512195121951
Reggie Jackson,2020.0,74,177,103,0.4180790960451977
Reggie Jackson,2021.0,180,424,244,0.42452830188679247
Reggie Jackson,2022.0,169,521,352,0.32437619961612285
Reggie Jackson,2023.0,97,290,193,0.33448275862068966
Reggie Jackson,2024.0,63,169,106,0.3727810650887574
Reggie Miller,2004.0,158,398,240,0.3969849246231156
Reggie Miller,2005.0,117,364,247,0.32142857142857145
Reggie Perry,2021.0,6,26,20,0.23076923076923078
Reggie Perry,2022.0,3,16,13,0.1875
Reggie Williams,2010.0,33,92,59,0.358695652173913
Reggie Williams,2011.0,102,241,139,0.42323651452282157
Reggie Williams,2012.0,33,107,74,0.308411214953271
Reggie Williams,2013.0,22,72,50,0.3055555555555556
Reggie Williams,2014.0,1,3,2,0.3333333333333333
Reggie Williams,2015.0,3,19,16,0.15789473684210525
Reggie Williams,2017.0,5,11,6,0.45454545454545453
Renaldo Balkman,2007.0,5,27,22,0.18518518518518517
Renaldo Balkman,2008.0,1,12,11,0.08333333333333333
Renaldo Balkman,2009.0,2,8,6,0.25
Renaldo Balkman,2010.0,0,7,7,0.0
Renaldo Balkman,2011.0,1,2,1,0.5
Renaldo Balkman,2012.0,2,9,7,0.2222222222222222
Richard Hamilton,2004.0,33,107,74,0.308411214953271
Richard Hamilton,2005.0,46,152,106,0.3026315789473684
Richard Hamilton,2006.0,69,160,91,0.43125
Richard Hamilton,2007.0,52,149,97,0.348993288590604
Richard Hamilton,2008.0,70,167,97,0.41916167664670656
Richard Hamilton,2009.0,72,200,128,0.36
Richard Hamilton,2010.0,41,138,97,0.2971014492753623
Richard Hamilton,2011.0,55,144,89,0.3819444444444444
Richard Hamilton,2012.0,19,52,33,0.36538461538461536
Richard Hamilton,2013.0,19,59,40,0.3220338983050847
Richard Jefferson,2004.0,57,165,108,0.34545454545454546
Richard Jefferson,2005.0,32,99,67,0.32323232323232326
Richard Jefferson,2006.0,72,217,145,0.3317972350230415
Richard Jefferson,2007.0,65,185,120,0.35135135135135137
Richard Jefferson,2008.0,77,213,136,0.3615023474178404
Richard Jefferson,2009.0,116,292,176,0.3972602739726027
Richard Jefferson,2010.0,60,192,132,0.3125
Richard Jefferson,2011.0,141,324,183,0.4351851851851852
Richard Jefferson,2012.0,113,269,156,0.4200743494423792
Richard Jefferson,2013.0,16,48,32,0.3333333333333333
Richard Jefferson,2014.0,123,301,178,0.40863787375415284
Richard Jefferson,2015.0,69,163,94,0.4233128834355828
Richard Jefferson,2016.0,77,201,124,0.38308457711442784
Richard Jefferson,2017.0,67,205,138,0.32682926829268294
Richard Jefferson,2018.0,2,7,5,0.2857142857142857
Richaun Holmes,2016.0,8,44,36,0.18181818181818182
Richaun Holmes,2017.0,27,77,50,0.35064935064935066
Richaun Holmes,2018.0,4,31,27,0.12903225806451613
Richaun Holmes,2021.0,2,11,9,0.18181818181818182
Richaun Holmes,2022.0,2,5,3,0.4
Richaun Holmes,2023.0,5,8,3,0.625
Richie Frahm,2004.0,34,92,58,0.3695652173913043
Richie Frahm,2005.0,31,80,49,0.3875
Richie Frahm,2006.0,23,70,47,0.32857142857142857
Richie Frahm,2008.0,7,25,18,0.28
Rick Brunson,2004.0,11,23,12,0.4782608695652174
Rick Brunson,2005.0,48,130,82,0.36923076923076925
Rick Brunson,2006.0,5,13,8,0.38461538461538464
Rick Fox,2004.0,16,68,52,0.23529411764705882
Ricky Council,2024.0,6,26,20,0.23076923076923078
Ricky Council IV,2024.0,4,9,5,0.4444444444444444
Ricky Davis,2004.0,56,150,94,0.37333333333333335
Ricky Davis,2005.0,64,189,125,0.3386243386243386
Ricky Davis,2006.0,73,242,169,0.30165289256198347
Ricky Davis,2007.0,123,310,187,0.3967741935483871
Ricky Davis,2008.0,135,333,198,0.40540540540540543
Ricky Davis,2009.0,35,111,76,0.3153153153153153
Ricky Davis,2010.0,16,42,26,0.38095238095238093
Ricky Ledo,2014.0,3,8,5,0.375
Ricky Ledo,2015.0,10,27,17,0.37037037037037035
Ricky Rubio,2012.0,32,94,62,0.3404255319148936
Ricky Rubio,2013.0,27,92,65,0.29347826086956524
Ricky Rubio,2014.0,44,133,89,0.3308270676691729
Ricky Rubio,2015.0,13,51,38,0.2549019607843137
Ricky Rubio,2016.0,62,190,128,0.3263157894736842
Ricky Rubio,2017.0,60,196,136,0.30612244897959184
Ricky Rubio,2018.0,106,305,199,0.3475409836065574
Ricky Rubio,2019.0,83,274,191,0.3029197080291971
Ricky Rubio,2020.0,78,216,138,0.3611111111111111
Ricky Rubio,2021.0,66,214,148,0.308411214953271
Ricky Rubio,2022.0,59,174,115,0.3390804597701149
Ricky Rubio,2023.0,21,82,61,0.25609756097560976
Rob Edwards,2022.0,1,4,3,0.25
Rob Kurz,2009.0,15,38,23,0.39473684210526316
Robbie Hummel,2014.0,32,89,57,0.3595505617977528
Robbie Hummel,2015.0,16,51,35,0.3137254901960784
Robert Covington,2014.0,4,11,7,0.36363636363636365
Robert Covington,2015.0,167,446,279,0.3744394618834081
Robert Covington,2016.0,170,482,312,0.35269709543568467
Robert Covington,2017.0,137,413,276,0.33171912832929784
Robert Covington,2018.0,218,597,379,0.36515912897822445
Robert Covington,2019.0,85,225,140,0.37777777777777777
Robert Covington,2020.0,195,548,353,0.35583941605839414
Robert Covington,2021.0,146,378,232,0.3862433862433862
Robert Covington,2022.0,130,343,213,0.37900874635568516
Robert Covington,2023.0,54,138,84,0.391304347826087
Robert Covington,2024.0,19,56,37,0.3392857142857143
Robert Franks,2021.0,5,15,10,0.3333333333333333
Robert Hite,2007.0,5,23,18,0.21739130434782608
Robert Horry,2004.0,49,130,81,0.3769230769230769
Robert Horry,2005.0,89,223,134,0.3991031390134529
Robert Horry,2006.0,59,161,102,0.36645962732919257
Robert Horry,2007.0,63,186,123,0.3387096774193548
Robert Horry,2008.0,23,92,69,0.25
Robert Sacre,2015.0,0,1,1,0.0
Robert Traylor,2004.0,2,5,3,0.4
Robert Traylor,2005.0,0,8,8,0.0
Robert Williams,2020.0,0,1,1,0.0
Robert Williams,2021.0,0,2,2,0.0
Robert Williams,2022.0,0,2,2,0.0
Robert Williams,2023.0,0,2,2,0.0
Robert Woodard,2021.0,1,6,5,0.16666666666666666
Robert Woodard,2022.0,1,4,3,0.25
Robin Lopez,2009.0,0,1,1,0.0
Robin Lopez,2014.0,0,1,1,0.0
Robin Lopez,2015.0,0,1,1,0.0
Robin Lopez,2016.0,0,1,1,0.0
Robin Lopez,2017.0,0,2,2,0.0
Robin Lopez,2018.0,4,14,10,0.2857142857142857
Robin Lopez,2019.0,7,31,24,0.22580645161290322
Robin Lopez,2020.0,35,105,70,0.3333333333333333
Robin Lopez,2021.0,5,18,13,0.2777777777777778
Robin Lopez,2022.0,2,6,4,0.3333333333333333
Robin Lopez,2023.0,2,4,2,0.5
Robin Lopez,2024.0,2,6,4,0.3333333333333333
Rod Strickland,2004.0,10,36,26,0.2777777777777778
Rod Strickland,2005.0,1,2,1,0.5
Rodions Kurucs,2019.0,60,192,132,0.3125
Rodions Kurucs,2020.0,33,98,65,0.336734693877551
Rodions Kurucs,2021.0,6,21,15,0.2857142857142857
Rodney Buford,2004.0,1,5,4,0.2
Rodney Buford,2005.0,34,108,74,0.3148148148148148
Rodney Carney,2007.0,25,72,47,0.3472222222222222
Rodney Carney,2008.0,43,130,87,0.33076923076923076
Rodney Carney,2009.0,79,226,147,0.3495575221238938
Rodney Carney,2010.0,41,135,94,0.3037037037037037
Rodney Carney,2011.0,17,38,21,0.4473684210526316
Rodney Hood,2015.0,62,170,108,0.36470588235294116
Rodney Hood,2016.0,161,449,288,0.3585746102449889
Rodney Hood,2017.0,127,356,229,0.35674157303370785
Rodney Hood,2018.0,131,357,226,0.36694677871148457
Rodney Hood,2019.0,102,287,185,0.3554006968641115
Rodney Hood,2020.0,35,71,36,0.49295774647887325
Rodney Hood,2021.0,34,113,79,0.3008849557522124
Rodney Hood,2022.0,30,91,61,0.32967032967032966
Rodney McGruder,2017.0,73,220,147,0.33181818181818185
Rodney McGruder,2018.0,15,37,22,0.40540540540540543
Rodney McGruder,2019.0,79,227,148,0.34801762114537443
Rodney McGruder,2020.0,26,92,66,0.2826086956521739
Rodney McGruder,2021.0,11,24,13,0.4583333333333333
Rodney McGruder,2022.0,58,146,88,0.3972602739726027
Rodney McGruder,2023.0,41,97,56,0.422680412371134
Rodney Purvis,2018.0,13,52,39,0.25
Rodney Rogers,2004.0,55,174,119,0.3160919540229885
Rodney Rogers,2005.0,51,176,125,0.2897727272727273
Rodney Stuckey,2008.0,5,23,18,0.21739130434782608
Rodney Stuckey,2009.0,23,86,63,0.26744186046511625
Rodney Stuckey,2010.0,18,79,61,0.22784810126582278
Rodney Stuckey,2011.0,26,90,64,0.28888888888888886
Rodney Stuckey,2012.0,33,104,71,0.3173076923076923
Rodney Stuckey,2013.0,53,176,123,0.30113636363636365
Rodney Stuckey,2014.0,24,88,64,0.2727272727272727
Rodney Stuckey,2015.0,55,141,86,0.3900709219858156
Rodney Stuckey,2016.0,25,93,68,0.26881720430107525
Rodney Stuckey,2017.0,19,60,41,0.31666666666666665
Rodney White,2004.0,33,90,57,0.36666666666666664
Rodney White,2005.0,24,60,36,0.4
Rodrigue Beaubois,2010.0,47,116,69,0.4051724137931034
Rodrigue Beaubois,2011.0,25,83,58,0.30120481927710846
Rodrigue Beaubois,2012.0,38,133,95,0.2857142857142857
Rodrigue Beaubois,2013.0,21,72,51,0.2916666666666667
Roger Mason,2004.0,13,39,26,0.3333333333333333
Roger Mason,2007.0,38,112,74,0.3392857142857143
Roger Mason,2008.0,134,344,210,0.38953488372093026
Roger Mason,2009.0,173,413,240,0.4188861985472155
Roger Mason,2010.0,89,271,182,0.3284132841328413
Roger Mason,2011.0,21,57,36,0.3684210526315789
Roger Mason,2012.0,59,154,95,0.38311688311688313
Roger Mason,2013.0,66,159,93,0.41509433962264153
Roger Mason,2014.0,17,48,31,0.3541666666666667
Roger Powell,2007.0,0,1,1,0.0
Roko Ukic,2009.0,11,62,51,0.1774193548387097
Roko Ukic,2010.0,3,12,9,0.25
Romeo Langford,2020.0,6,29,23,0.20689655172413793
Romeo Langford,2021.0,11,35,24,0.3142857142857143
Romeo Langford,2022.0,29,85,56,0.3411764705882353
Romeo Langford,2023.0,16,61,45,0.26229508196721313
Ron Baker,2017.0,23,85,62,0.27058823529411763
Ron Baker,2018.0,11,33,22,0.3333333333333333
Ron Baker,2019.0,1,13,12,0.07692307692307693
Ron Harper,2023.0,3,9,6,0.3333333333333333
Ron Mercer,2004.0,2,7,5,0.2857142857142857
Ron Mercer,2005.0,0,3,3,0.0
Ronald Dupree,2004.0,4,9,5,0.4444444444444444
Ronald Dupree,2005.0,1,2,1,0.5
Ronald Dupree,2006.0,0,1,1,0.0
Ronald Dupree,2011.0,0,1,1,0.0
Ronald Murray,2004.0,67,229,162,0.2925764192139738
Ronald Murray,2005.0,24,97,73,0.24742268041237114
Ronald Murray,2006.0,42,165,123,0.2545454545454545
Ronald Murray,2007.0,24,85,61,0.2823529411764706
Ronald Murray,2008.0,20,63,43,0.31746031746031744
Ronald Murray,2009.0,101,292,191,0.3458904109589041
Ronald Murray,2010.0,73,233,160,0.3133047210300429
Rondae Hollis-Jefferson,2016.0,4,14,10,0.2857142857142857
Rondae Hollis-Jefferson,2017.0,15,65,50,0.23076923076923078
Rondae Hollis-Jefferson,2018.0,13,54,41,0.24074074074074073
Rondae Hollis-Jefferson,2019.0,10,50,40,0.2
Rondae Hollis-Jefferson,2020.0,3,24,21,0.125
Rondae Hollis-Jefferson,2021.0,0,1,1,0.0
Ronnie Brewer,2007.0,0,9,9,0.0
Ronnie Brewer,2008.0,12,56,44,0.21428571428571427
Ronnie Brewer,2009.0,22,87,65,0.25287356321839083
Ronnie Brewer,2010.0,8,31,23,0.25806451612903225
Ronnie Brewer,2011.0,9,34,25,0.2647058823529412
Ronnie Brewer,2012.0,19,69,50,0.2753623188405797
Ronnie Brewer,2013.0,23,76,53,0.3026315789473684
Ronnie Brewer,2014.0,1,8,7,0.125
Ronnie Price,2006.0,6,27,21,0.2222222222222222
Ronnie Price,2007.0,21,65,44,0.3230769230769231
Ronnie Price,2008.0,29,89,60,0.3258426966292135
Ronnie Price,2009.0,19,64,45,0.296875
Ronnie Price,2010.0,20,70,50,0.2857142857142857
Ronnie Price,2011.0,20,69,49,0.2898550724637681
Ronnie Price,2012.0,13,44,31,0.29545454545454547
Ronnie Price,2013.0,10,39,29,0.2564102564102564
Ronnie Price,2014.0,9,43,34,0.20930232558139536
Ronnie Price,2015.0,31,109,78,0.28440366972477066
Ronnie Price,2016.0,68,196,128,0.3469387755102041
Ronnie Price,2017.0,3,17,14,0.17647058823529413
Ronny Turiaf,2007.0,0,1,1,0.0
Ronny Turiaf,2008.0,0,1,1,0.0
Ronny Turiaf,2009.0,0,3,3,0.0
Ronny Turiaf,2010.0,0,1,1,0.0
Ronny Turiaf,2012.0,0,1,1,0.0
Roy Hibbert,2010.0,3,6,3,0.5
Roy Hibbert,2011.0,0,4,4,0.0
Roy Hibbert,2012.0,1,2,1,0.5
Roy Hibbert,2013.0,1,4,3,0.25
Roy Hibbert,2014.0,2,6,4,0.3333333333333333
Roy Hibbert,2015.0,0,2,2,0.0
Roy Hibbert,2016.0,0,2,2,0.0
Royal Ivey,2005.0,3,9,6,0.3333333333333333
Royal Ivey,2006.0,4,10,6,0.4
Royal Ivey,2007.0,5,16,11,0.3125
Royal Ivey,2008.0,35,107,72,0.32710280373831774
Royal Ivey,2009.0,41,121,80,0.33884297520661155
Royal Ivey,2010.0,14,37,23,0.3783783783783784
Royal Ivey,2011.0,9,18,9,0.5
Royal Ivey,2012.0,20,58,38,0.3448275862068966
Royal Ivey,2013.0,37,88,51,0.42045454545454547
Royal Ivey,2014.0,0,1,1,0.0
Royce O'Neale,2018.0,52,146,94,0.3561643835616438
Royce O'Neale,2019.0,76,199,123,0.38190954773869346
Royce O'Neale,2020.0,102,266,164,0.38345864661654133
Royce O'Neale,2021.0,135,338,203,0.3994082840236686
Royce O'Neale,2022.0,126,331,205,0.3806646525679758
Royce O'Neale,2023.0,167,441,274,0.3786848072562358
Royce O'Neale,2024.0,82,229,147,0.35807860262008734
Ruben Patterson,2004.0,2,12,10,0.16666666666666666
Ruben Patterson,2005.0,2,25,23,0.08
Ruben Patterson,2006.0,1,13,12,0.07692307692307693
Ruben Patterson,2007.0,3,19,16,0.15789473684210525
Ruben Patterson,2008.0,0,2,2,0.0
Rudy Fernandez,2009.0,167,417,250,0.40047961630695444
Rudy Fernandez,2010.0,109,289,180,0.3771626297577855
Rudy Fernandez,2011.0,119,371,252,0.32075471698113206
Rudy Fernandez,2012.0,40,122,82,0.32786885245901637
Rudy Gay,2007.0,52,143,91,0.36363636363636365
Rudy Gay,2008.0,134,387,253,0.3462532299741602
Rudy Gay,2009.0,85,242,157,0.3512396694214876
Rudy Gay,2010.0,66,202,136,0.32673267326732675
Rudy Gay,2011.0,57,144,87,0.3958333333333333
Rudy Gay,2012.0,58,192,134,0.3020833333333333
Rudy Gay,2013.0,84,260,176,0.3230769230769231
Rudy Gay,2014.0,65,197,132,0.3299492385786802
Rudy Gay,2015.0,79,220,141,0.35909090909090907
Rudy Gay,2016.0,74,215,141,0.34418604651162793
Rudy Gay,2017.0,42,113,71,0.37168141592920356
Rudy Gay,2018.0,41,136,95,0.3014705882352941
Rudy Gay,2019.0,82,203,121,0.4039408866995074
Rudy Gay,2020.0,74,220,146,0.33636363636363636
Rudy Gay,2021.0,109,285,176,0.3824561403508772
Rudy Gay,2022.0,70,203,133,0.3448275862068966
Rudy Gay,2023.0,33,130,97,0.25384615384615383
Rudy Gobert,2015.0,0,2,2,0.0
Rudy Gobert,2017.0,0,1,1,0.0
Rudy Gobert,2021.0,0,5,5,0.0
Rudy Gobert,2022.0,0,4,4,0.0
Rudy Gobert,2023.0,0,3,3,0.0
Rudy Gobert,2024.0,0,2,2,0.0
Rui Hachimura,2020.0,25,87,62,0.28735632183908044
Rui Hachimura,2021.0,56,155,99,0.36129032258064514
Rui Hachimura,2022.0,55,123,68,0.44715447154471544
Rui Hachimura,2023.0,70,199,129,0.35175879396984927
Rui Hachimura,2024.0,36,95,59,0.37894736842105264
Russ Smith,2015.0,2,11,9,0.18181818181818182
Russ Smith,2016.0,1,5,4,0.2
Russell Westbrook,2009.0,35,129,94,0.2713178294573643
Russell Westbrook,2010.0,28,116,88,0.2413793103448276
Russell Westbrook,2011.0,48,151,103,0.31788079470198677
Russell Westbrook,2012.0,80,261,181,0.3065134099616858
Russell Westbrook,2013.0,99,309,210,0.32038834951456313
Russell Westbrook,2014.0,96,314,218,0.3057324840764331
Russell Westbrook,2015.0,86,288,202,0.2986111111111111
Russell Westbrook,2016.0,135,446,311,0.30269058295964124
Russell Westbrook,2017.0,213,632,419,0.3370253164556962
Russell Westbrook,2018.0,112,368,256,0.30434782608695654
Russell Westbrook,2019.0,130,445,315,0.29213483146067415
Russell Westbrook,2020.0,63,246,183,0.25609756097560976
Russell Westbrook,2021.0,91,298,207,0.3053691275167785
Russell Westbrook,2022.0,79,265,186,0.2981132075471698
Russell Westbrook,2023.0,99,314,215,0.31528662420382164
Russell Westbrook,2024.0,30,102,72,0.29411764705882354
Rusty LaRue,2004.0,1,1,0,1.0
Ryan Anderson,2009.0,69,189,120,0.36507936507936506
Ryan Anderson,2010.0,82,225,143,0.36444444444444446
Ryan Anderson,2011.0,140,361,221,0.3878116343490305
Ryan Anderson,2012.0,178,452,274,0.3938053097345133
Ryan Anderson,2013.0,213,557,344,0.38240574506283664
Ryan Anderson,2014.0,67,164,97,0.40853658536585363
Ryan Anderson,2015.0,127,371,244,0.3423180592991914
Ryan Anderson,2016.0,131,358,227,0.3659217877094972
Ryan Anderson,2017.0,222,568,346,0.3908450704225352
Ryan Anderson,2018.0,136,354,218,0.384180790960452
Ryan Anderson,2019.0,9,40,31,0.225
Ryan Anderson,2020.0,1,5,4,0.2
Ryan Arcidiacono,2018.0,9,31,22,0.2903225806451613
Ryan Arcidiacono,2019.0,81,218,137,0.37155963302752293
Ryan Arcidiacono,2020.0,54,138,84,0.391304347826087
Ryan Arcidiacono,2021.0,25,67,42,0.373134328358209
Ryan Arcidiacono,2022.0,4,9,5,0.4444444444444444
Ryan Arcidiacono,2023.0,8,23,15,0.34782608695652173
Ryan Arcidiacono,2024.0,0,6,6,0.0
Ryan Bowen,2005.0,3,6,3,0.5
Ryan Bowen,2006.0,3,22,19,0.13636363636363635
Ryan Bowen,2008.0,0,2,2,0.0
Ryan Broekhoff,2019.0,38,94,56,0.40425531914893614
Ryan Broekhoff,2020.0,20,51,31,0.39215686274509803
Ryan Gomes,2006.0,3,9,6,0.3333333333333333
Ryan Gomes,2007.0,16,42,26,0.38095238095238093
Ryan Gomes,2008.0,59,179,120,0.329608938547486
Ryan Gomes,2009.0,106,285,179,0.3719298245614035
Ryan Gomes,2010.0,74,199,125,0.37185929648241206
Ryan Gomes,2011.0,72,211,139,0.3412322274881517
Ryan Gomes,2012.0,4,29,25,0.13793103448275862
Ryan Gomes,2014.0,0,2,2,0.0
Ryan Hollins,2010.0,0,1,1,0.0
Ryan Humphrey,2004.0,0,1,1,0.0
Ryan Humphrey,2005.0,0,2,2,0.0
Ryan Kelly,2014.0,48,142,94,0.3380281690140845
Ryan Kelly,2015.0,45,134,89,0.3358208955223881
Ryan Kelly,2016.0,5,37,32,0.13513513513513514
Ryan Kelly,2017.0,4,10,6,0.4
Ryan Rollins,2023.0,3,9,6,0.3333333333333333
Ryan Rollins,2024.0,2,3,1,0.6666666666666666
Saben Lee,2021.0,8,23,15,0.34782608695652173
Saben Lee,2022.0,14,60,46,0.23333333333333334
Saben Lee,2023.0,11,30,19,0.36666666666666664
Saben Lee,2024.0,0,5,5,0.0
Saddiq Bey,2021.0,175,460,285,0.3804347826086957
Saddiq Bey,2022.0,211,610,399,0.34590163934426227
Saddiq Bey,2023.0,158,436,278,0.3623853211009174
Saddiq Bey,2024.0,80,259,179,0.3088803088803089
Salah Mejri,2016.0,0,1,1,0.0
Salah Mejri,2017.0,1,3,2,0.3333333333333333
Salah Mejri,2018.0,0,3,3,0.0
Salah Mejri,2019.0,11,34,23,0.3235294117647059
Salim Stoudamire,2006.0,80,208,128,0.38461538461538464
Salim Stoudamire,2007.0,56,155,99,0.36129032258064514
Salim Stoudamire,2008.0,31,91,60,0.34065934065934067
Sam Cassell,2004.0,99,246,147,0.4024390243902439
Sam Cassell,2005.0,27,103,76,0.2621359223300971
Sam Cassell,2006.0,85,233,148,0.3648068669527897
Sam Cassell,2007.0,32,109,77,0.29357798165137616
Sam Cassell,2008.0,29,104,75,0.27884615384615385
Sam Dekker,2017.0,63,193,130,0.32642487046632124
Sam Dekker,2018.0,10,60,50,0.16666666666666666
Sam Dekker,2019.0,19,62,43,0.3064516129032258
Sam Hauser,2022.0,20,47,27,0.425531914893617
Sam Hauser,2023.0,148,359,211,0.41225626740947074
Sam Hauser,2024.0,99,243,144,0.4074074074074074
Sam Merrill,2021.0,22,52,30,0.4230769230769231
Sam Merrill,2022.0,7,23,16,0.30434782608695654
Sam Merrill,2023.0,5,18,13,0.2777777777777778
Sam Merrill,2024.0,71,166,95,0.42771084337349397
Sam Young,2010.0,11,56,45,0.19642857142857142
Sam Young,2011.0,20,62,42,0.3225806451612903
Sam Young,2012.0,5,18,13,0.2777777777777778
Sam Young,2013.0,18,62,44,0.2903225806451613
Samaki Walker,2004.0,0,2,2,0.0
Samardo Samuels,2011.0,0,3,3,0.0
Samardo Samuels,2013.0,0,1,1,0.0
Samuel Dalembert,2004.0,0,1,1,0.0
Samuel Dalembert,2006.0,0,1,1,0.0
Samuel Dalembert,2007.0,0,2,2,0.0
Samuel Dalembert,2008.0,0,1,1,0.0
Samuel Dalembert,2009.0,0,2,2,0.0
Samuel Dalembert,2011.0,0,2,2,0.0
Samuel Dalembert,2012.0,0,1,1,0.0
Samuel Dalembert,2013.0,1,1,0,1.0
Samuel Dalembert,2014.0,0,1,1,0.0
Sandro Mamukelashvili,2022.0,22,52,30,0.4230769230769231
Sandro Mamukelashvili,2023.0,30,99,69,0.30303030303030304
Sandro Mamukelashvili,2024.0,8,32,24,0.25
Santi Aldama,2022.0,6,48,42,0.125
Santi Aldama,2023.0,101,281,180,0.3594306049822064
Santi Aldama,2024.0,54,160,106,0.3375
Sarunas Jasikevicius,2006.0,88,245,157,0.35918367346938773
Sarunas Jasikevicius,2007.0,44,130,86,0.3384615384615385
Sasha Pavlovic,2004.0,19,70,51,0.2714285714285714
Sasha Pavlovic,2005.0,30,78,48,0.38461538461538464
Sasha Pavlovic,2006.0,35,97,62,0.36082474226804123
Sasha Pavlovic,2007.0,80,206,126,0.3883495145631068
Sasha Pavlovic,2008.0,38,123,85,0.3089430894308943
Sasha Pavlovic,2009.0,50,125,75,0.4
Sasha Pavlovic,2010.0,35,118,83,0.2966101694915254
Sasha Pavlovic,2011.0,12,31,19,0.3870967741935484
Sasha Pavlovic,2012.0,18,63,45,0.2857142857142857
Sasha Pavlovic,2013.0,18,60,42,0.3
Sasha Vezenkov,2024.0,29,80,51,0.3625
Sasha Vujacic,2005.0,17,63,46,0.2698412698412698
Sasha Vujacic,2006.0,68,187,119,0.36363636363636365
Sasha Vujacic,2007.0,61,165,104,0.3696969696969697
Sasha Vujacic,2008.0,149,349,200,0.4269340974212034
Sasha Vujacic,2009.0,97,274,177,0.354014598540146
Sasha Vujacic,2010.0,31,96,65,0.3229166666666667
Sasha Vujacic,2011.0,97,262,165,0.3702290076335878
Sasha Vujacic,2014.0,1,2,1,0.5
Sasha Vujacic,2016.0,52,143,91,0.36363636363636365
Sasha Vujacic,2017.0,23,74,51,0.3108108108108108
Scoot Henderson,2024.0,40,126,86,0.31746031746031744
Scott Machado,2013.0,0,1,1,0.0
Scott Machado,2019.0,1,1,0,1.0
Scott Padgett,2004.0,29,68,39,0.4264705882352941
Scott Padgett,2005.0,55,138,83,0.39855072463768115
Scott Padgett,2006.0,42,122,80,0.3442622950819672
Scott Padgett,2007.0,8,33,25,0.24242424242424243
Scott Williams,2004.0,2,3,1,0.6666666666666666
Scott Williams,2005.0,0,1,1,0.0
Scottie Barnes,2022.0,60,205,145,0.2926829268292683
Scottie Barnes,2023.0,63,224,161,0.28125
Scottie Barnes,2024.0,89,245,156,0.363265306122449
Scottie Pippen,2004.0,13,48,35,0.2708333333333333
Scotty Hopson,2014.0,0,2,2,0.0
Scotty Hopson,2022.0,0,1,1,0.0
Scotty Pippen,2023.0,1,3,2,0.3333333333333333
Scotty Pippen,2024.0,2,3,1,0.6666666666666666
Sean Kilpatrick,2015.0,4,13,9,0.3076923076923077
Sean Kilpatrick,2016.0,39,114,75,0.34210526315789475
Sean Kilpatrick,2017.0,104,307,203,0.33876221498371334
Sean Kilpatrick,2018.0,46,143,97,0.32167832167832167
Sean Marks,2005.0,0,3,3,0.0
Sean Marks,2006.0,0,3,3,0.0
Sean Marks,2007.0,0,1,1,0.0
Sean Marks,2008.0,1,4,3,0.25
Sean Marks,2009.0,2,11,9,0.18181818181818182
Sean Marks,2011.0,2,2,0,1.0
Sean May,2006.0,0,5,5,0.0
Sean May,2007.0,2,3,1,0.6666666666666666
Sean May,2009.0,1,1,0,1.0
Sean May,2010.0,0,4,4,0.0
Sean McDermott,2021.0,5,22,17,0.22727272727272727
Sean Rooks,2004.0,0,1,1,0.0
Sean Singletary,2009.0,10,25,15,0.4
Sean Williams,2010.0,0,1,1,0.0
Sebastian Telfair,2005.0,17,69,52,0.2463768115942029
Sebastian Telfair,2006.0,57,162,105,0.35185185185185186
Sebastian Telfair,2007.0,37,128,91,0.2890625
Sebastian Telfair,2008.0,32,114,82,0.2807017543859649
Sebastian Telfair,2009.0,73,211,138,0.3459715639810427
Sebastian Telfair,2010.0,13,56,43,0.23214285714285715
Sebastian Telfair,2011.0,28,78,50,0.358974358974359
Sebastian Telfair,2012.0,33,105,72,0.3142857142857143
Sebastian Telfair,2013.0,53,150,97,0.35333333333333333
Sebastian Telfair,2015.0,18,60,42,0.3
Sekou Doumbouya,2020.0,28,98,70,0.2857142857142857
Sekou Doumbouya,2021.0,26,115,89,0.22608695652173913
Sekou Doumbouya,2022.0,1,2,1,0.5
Semaj Christon,2017.0,13,66,53,0.19696969696969696
Semi Ojeleye,2018.0,46,148,102,0.3108108108108108
Semi Ojeleye,2019.0,31,94,63,0.32978723404255317
Semi Ojeleye,2020.0,53,150,97,0.35333333333333333
Semi Ojeleye,2021.0,58,162,104,0.35802469135802467
Semi Ojeleye,2022.0,15,50,35,0.3
Serge Ibaka,2010.0,1,2,1,0.5
Serge Ibaka,2011.0,0,2,2,0.0
Serge Ibaka,2012.0,2,7,5,0.2857142857142857
Serge Ibaka,2013.0,24,66,42,0.36363636363636365
Serge Ibaka,2014.0,28,73,45,0.3835616438356164
Serge Ibaka,2015.0,77,205,128,0.375609756097561
Serge Ibaka,2016.0,91,253,162,0.35968379446640314
Serge Ibaka,2017.0,136,356,220,0.38202247191011235
Serge Ibaka,2018.0,116,321,205,0.3613707165109034
Serge Ibaka,2019.0,58,207,149,0.28019323671497587
Serge Ibaka,2020.0,93,227,134,0.40969162995594716
Serge Ibaka,2021.0,39,117,78,0.3333333333333333
Serge Ibaka,2022.0,37,102,65,0.3627450980392157
Serge Ibaka,2023.0,6,18,12,0.3333333333333333
Sergei Monia,2006.0,9,34,25,0.2647058823529412
Sergey Karasev,2014.0,4,19,15,0.21052631578947367
Sergey Karasev,2015.0,16,54,38,0.2962962962962963
Sergey Karasev,2016.0,11,37,26,0.2972972972972973
Sergio Rodriguez,2007.0,24,85,61,0.2823529411764706
Sergio Rodriguez,2008.0,17,58,41,0.29310344827586204
Sergio Rodriguez,2009.0,37,114,77,0.32456140350877194
Sergio Rodriguez,2010.0,32,91,59,0.3516483516483517
Sergio Rodriguez,2017.0,92,252,160,0.36507936507936506
Seth Curry,2014.0,1,1,0,1.0
Seth Curry,2015.0,0,1,1,0.0
Seth Curry,2016.0,50,111,61,0.45045045045045046
Seth Curry,2017.0,137,321,184,0.42679127725856697
Seth Curry,2019.0,134,303,169,0.44224422442244227
Seth Curry,2020.0,155,342,187,0.45321637426900585
Seth Curry,2021.0,167,361,194,0.4626038781163435
Seth Curry,2022.0,170,397,227,0.4282115869017632
Seth Curry,2023.0,97,241,144,0.4024896265560166
Seth Curry,2024.0,29,77,48,0.37662337662337664
Seth Lundy,2024.0,3,13,10,0.23076923076923078
Shabazz Muhammad,2014.0,3,11,8,0.2727272727272727
Shabazz Muhammad,2015.0,20,51,31,0.39215686274509803
Shabazz Muhammad,2016.0,44,152,108,0.2894736842105263
Shabazz Muhammad,2017.0,49,147,98,0.3333333333333333
Shabazz Muhammad,2018.0,11,32,21,0.34375
Shabazz Napier,2015.0,43,118,75,0.3644067796610169
Shabazz Napier,2016.0,34,104,70,0.3269230769230769
Shabazz Napier,2017.0,39,105,66,0.37142857142857144
Shabazz Napier,2018.0,82,222,140,0.36936936936936937
Shabazz Napier,2019.0,79,233,154,0.33905579399141633
Shabazz Napier,2020.0,76,240,164,0.31666666666666665
Shaedon Sharpe,2023.0,102,283,181,0.36042402826855124
Shaedon Sharpe,2024.0,60,180,120,0.3333333333333333
Shai Gilgeous-Alexander,2019.0,60,157,97,0.3821656050955414
Shai Gilgeous-Alexander,2020.0,101,286,185,0.3531468531468531
Shai Gilgeous-Alexander,2021.0,71,170,99,0.4176470588235294
Shai Gilgeous-Alexander,2022.0,89,297,208,0.2996632996632997
Shai Gilgeous-Alexander,2023.0,58,168,110,0.34523809523809523
Shai Gilgeous-Alexander,2024.0,52,155,103,0.33548387096774196
Shake Milton,2019.0,14,44,30,0.3181818181818182
Shake Milton,2020.0,68,160,92,0.425
Shake Milton,2021.0,79,222,143,0.35585585585585583
Shake Milton,2022.0,51,148,97,0.34459459459459457
Shake Milton,2023.0,56,149,93,0.37583892617449666
Shake Milton,2024.0,14,53,39,0.2641509433962264
Shammond Williams,2004.0,30,101,71,0.297029702970297
Shammond Williams,2007.0,22,58,36,0.3793103448275862
Shamorie Ponds,2020.0,1,2,1,0.5
Shandon Anderson,2004.0,38,135,97,0.2814814814814815
Shandon Anderson,2005.0,5,30,25,0.16666666666666666
Shandon Anderson,2006.0,6,22,16,0.2727272727272727
Shane Battier,2004.0,68,193,125,0.35233160621761656
Shane Battier,2005.0,71,184,113,0.3858695652173913
Shane Battier,2006.0,67,172,105,0.38953488372093026
Shane Battier,2007.0,176,416,240,0.4230769230769231
Shane Battier,2008.0,151,394,243,0.383248730964467
Shane Battier,2009.0,108,291,183,0.3711340206185567
Shane Battier,2010.0,101,279,178,0.36200716845878134
Shane Battier,2011.0,110,296,186,0.3716216216216216
Shane Battier,2012.0,104,293,189,0.35494880546075086
Shane Battier,2013.0,162,404,242,0.400990099009901
Shane Battier,2014.0,82,230,148,0.3565217391304348
Shane Heal,2004.0,4,18,14,0.2222222222222222
Shane Larkin,2014.0,12,39,27,0.3076923076923077
Shane Larkin,2015.0,35,116,81,0.3017241379310345
Shane Larkin,2016.0,39,108,69,0.3611111111111111
Shane Larkin,2018.0,35,99,64,0.35353535353535354
Shannon Brown,2007.0,7,25,18,0.28
Shannon Brown,2008.0,9,30,21,0.3
Shannon Brown,2009.0,26,62,36,0.41935483870967744
Shannon Brown,2010.0,71,221,150,0.3212669683257919
Shannon Brown,2011.0,81,237,156,0.34177215189873417
Shannon Brown,2012.0,68,188,120,0.3617021276595745
Shannon Brown,2013.0,39,141,102,0.2765957446808511
Shannon Brown,2014.0,0,2,2,0.0
Shannon Brown,2015.0,3,7,4,0.42857142857142855
Shaq Buchanan,2022.0,0,2,2,0.0
Shaquille Harrison,2018.0,6,26,20,0.23076923076923078
Shaquille Harrison,2019.0,24,89,65,0.2696629213483146
Shaquille Harrison,2020.0,16,42,26,0.38095238095238093
Shaquille Harrison,2021.0,4,17,13,0.23529411764705882
Shaquille Harrison,2022.0,0,2,2,0.0
Shaquille Harrison,2023.0,4,11,7,0.36363636363636365
Shaquille O'Neal,2009.0,0,1,1,0.0
Shaquille O'Neal,2010.0,0,1,1,0.0
Shareef Abdur-Rahim,2004.0,9,34,25,0.2647058823529412
Shareef Abdur-Rahim,2005.0,15,39,24,0.38461538461538464
Shareef Abdur-Rahim,2006.0,5,25,20,0.2
Shareef Abdur-Rahim,2007.0,3,20,17,0.15
Sharife Cooper,2022.0,1,6,5,0.16666666666666666
Shaun Livingston,2005.0,0,2,2,0.0
Shaun Livingston,2006.0,2,9,7,0.2222222222222222
Shaun Livingston,2007.0,5,16,11,0.3125
Shaun Livingston,2010.0,0,6,6,0.0
Shaun Livingston,2011.0,1,4,3,0.25
Shaun Livingston,2012.0,2,3,1,0.6666666666666666
Shaun Livingston,2013.0,0,4,4,0.0
Shaun Livingston,2014.0,2,7,5,0.2857142857142857
Shaun Livingston,2015.0,0,3,3,0.0
Shaun Livingston,2016.0,2,13,11,0.15384615384615385
Shaun Livingston,2017.0,1,2,1,0.5
Shaun Livingston,2018.0,0,6,6,0.0
Shaun Livingston,2019.0,0,4,4,0.0
Shavlik Randolph,2009.0,1,1,0,1.0
Shavlik Randolph,2015.0,0,5,5,0.0
Shawn Bradley,2004.0,0,1,1,0.0
Shawn Long,2017.0,7,19,12,0.3684210526315789
Shawn Marion,2004.0,90,265,175,0.33962264150943394
Shawn Marion,2005.0,132,384,252,0.34375
Shawn Marion,2006.0,118,360,242,0.3277777777777778
Shawn Marion,2007.0,92,286,194,0.32167832167832167
Shawn Marion,2008.0,66,198,132,0.3333333333333333
Shawn Marion,2009.0,10,53,43,0.18867924528301888
Shawn Marion,2010.0,3,23,20,0.13043478260869565
Shawn Marion,2011.0,5,38,33,0.13157894736842105
Shawn Marion,2012.0,24,82,58,0.2926829268292683
Shawn Marion,2013.0,23,73,50,0.3150684931506849
Shawn Marion,2014.0,62,180,118,0.34444444444444444
Shawn Marion,2015.0,12,46,34,0.2608695652173913
Shawne Williams,2007.0,19,52,33,0.36538461538461536
Shawne Williams,2008.0,43,137,94,0.31386861313868614
Shawne Williams,2009.0,1,17,16,0.058823529411764705
Shawne Williams,2011.0,91,226,135,0.4026548672566372
Shawne Williams,2012.0,21,87,66,0.2413793103448276
Shawne Williams,2014.0,42,129,87,0.32558139534883723
Shawne Williams,2015.0,64,178,114,0.3595505617977528
Shayne Whittington,2015.0,1,6,5,0.16666666666666666
Shayne Whittington,2016.0,0,2,2,0.0
Shelden Williams,2007.0,2,4,2,0.5
Shelden Williams,2008.0,0,2,2,0.0
Shelden Williams,2009.0,0,2,2,0.0
Shelden Williams,2010.0,0,1,1,0.0
Sheldon McClellan,2017.0,9,35,26,0.2571428571428571
Shelvin Mack,2012.0,12,42,30,0.2857142857142857
Shelvin Mack,2013.0,20,54,34,0.37037037037037035
Shelvin Mack,2014.0,72,211,139,0.3412322274881517
Shelvin Mack,2015.0,46,148,102,0.3108108108108108
Shelvin Mack,2016.0,39,125,86,0.312
Shelvin Mack,2017.0,44,135,91,0.32592592592592595
Shelvin Mack,2018.0,48,139,91,0.34532374100719426
Shelvin Mack,2019.0,46,130,84,0.35384615384615387
Sherron Collins,2011.0,2,10,8,0.2
Sidy Cissoko,2024.0,0,4,4,0.0
Simone Fontecchio,2023.0,63,191,128,0.3298429319371728
Simone Fontecchio,2024.0,84,210,126,0.4
Sindarius Thornwell,2018.0,23,61,38,0.3770491803278688
Sindarius Thornwell,2019.0,4,18,14,0.2222222222222222
Sindarius Thornwell,2020.0,2,4,2,0.5
Sindarius Thornwell,2021.0,7,23,16,0.30434782608695654
Sir'Jabari Rice,2024.0,5,21,16,0.23809523809523808
Skal Labissiere,2017.0,3,8,5,0.375
Skal Labissiere,2018.0,18,51,33,0.35294117647058826
Skal Labissiere,2019.0,6,15,9,0.4
Skal Labissiere,2020.0,3,13,10,0.23076923076923078
Skylar Mays,2021.0,14,40,26,0.35
Skylar Mays,2022.0,8,25,17,0.32
Skylar Mays,2023.0,12,26,14,0.46153846153846156
Skylar Mays,2024.0,16,51,35,0.3137254901960784
Smush Parker,2005.0,3,13,10,0.23076923076923078
Smush Parker,2006.0,124,354,230,0.3502824858757062
Smush Parker,2007.0,111,307,196,0.36156351791530944
Smush Parker,2008.0,18,78,60,0.23076923076923078
Solomon Hill,2014.0,7,23,16,0.30434782608695654
Solomon Hill,2015.0,68,208,140,0.3269230769230769
Solomon Hill,2016.0,35,93,58,0.3763440860215054
Solomon Hill,2017.0,94,270,176,0.34814814814814815
Solomon Hill,2018.0,10,37,27,0.2702702702702703
Solomon Hill,2019.0,32,101,69,0.31683168316831684
Solomon Hill,2020.0,65,176,111,0.3693181818181818
Solomon Hill,2021.0,71,230,159,0.30869565217391304
Solomon Hill,2022.0,2,13,11,0.15384615384615385
Solomon Jones,2007.0,0,1,1,0.0
Solomon Jones,2008.0,0,2,2,0.0
Solomon Jones,2009.0,1,2,1,0.5
Solomon Jones,2010.0,0,3,3,0.0
Solomon Jones,2011.0,0,1,1,0.0
Sonny Weems,2009.0,0,3,3,0.0
Sonny Weems,2010.0,2,15,13,0.13333333333333333
Sonny Weems,2011.0,17,61,44,0.2786885245901639
Sonny Weems,2016.0,15,41,26,0.36585365853658536
Speedy Claxton,2004.0,4,22,18,0.18181818181818182
Speedy Claxton,2005.0,11,61,50,0.18032786885245902
Speedy Claxton,2006.0,17,63,46,0.2698412698412698
Speedy Claxton,2007.0,6,28,22,0.21428571428571427
Spencer Dinwiddie,2015.0,12,65,53,0.18461538461538463
Spencer Dinwiddie,2016.0,1,10,9,0.1
Spencer Dinwiddie,2017.0,37,98,61,0.37755102040816324
Spencer Dinwiddie,2018.0,141,433,292,0.325635103926097
Spencer Dinwiddie,2019.0,133,394,261,0.33756345177664976
Spencer Dinwiddie,2020.0,123,400,277,0.3075
Spencer Dinwiddie,2021.0,2,7,5,0.2857142857142857
Spencer Dinwiddie,2022.0,152,425,273,0.35764705882352943
Spencer Dinwiddie,2023.0,188,508,320,0.3700787401574803
Spencer Dinwiddie,2024.0,84,257,173,0.32684824902723736
Spencer Hawes,2008.0,4,21,17,0.19047619047619047
Spencer Hawes,2009.0,40,115,75,0.34782608695652173
Spencer Hawes,2010.0,26,87,61,0.2988505747126437
Spencer Hawes,2011.0,9,38,29,0.23684210526315788
Spencer Hawes,2012.0,5,17,12,0.29411764705882354
Spencer Hawes,2013.0,31,87,56,0.3563218390804598
Spencer Hawes,2014.0,128,308,180,0.4155844155844156
Spencer Hawes,2015.0,58,182,124,0.31868131868131866
Spencer Hawes,2016.0,39,106,67,0.36792452830188677
Spencer Hawes,2017.0,26,83,57,0.3132530120481928
Stacey Augmon,2004.0,1,8,7,0.125
Stanislav Medvedenko,2004.0,0,3,3,0.0
Stanislav Medvedenko,2005.0,0,1,1,0.0
Stanislav Medvedenko,2007.0,1,2,1,0.5
Stanley Johnson,2016.0,69,215,146,0.3209302325581395
Stanley Johnson,2017.0,45,154,109,0.2922077922077922
Stanley Johnson,2018.0,67,234,167,0.2863247863247863
Stanley Johnson,2019.0,62,215,153,0.28837209302325584
Stanley Johnson,2020.0,9,29,20,0.3103448275862069
Stanley Johnson,2021.0,45,137,92,0.3284671532846715
Stanley Johnson,2022.0,33,105,72,0.3142857142857143
Stanley Johnson,2023.0,18,40,22,0.45
Stanley Umude,2023.0,0,1,1,0.0
Stanley Umude,2024.0,14,27,13,0.5185185185185185
Stanton Kidd,2020.0,0,1,1,0.0
Stephen Curry,2010.0,166,380,214,0.4368421052631579
Stephen Curry,2011.0,151,342,191,0.4415204678362573
Stephen Curry,2012.0,55,121,66,0.45454545454545453
Stephen Curry,2013.0,314,706,392,0.4447592067988669
Stephen Curry,2014.0,283,672,389,0.4211309523809524
Stephen Curry,2015.0,384,878,494,0.43735763097949887
Stephen Curry,2016.0,482,1084,602,0.4446494464944649
Stephen Curry,2017.0,396,961,565,0.4120707596253902
Stephen Curry,2018.0,276,663,387,0.416289592760181
Stephen Curry,2019.0,446,1054,608,0.42314990512333966
Stephen Curry,2020.0,12,49,37,0.24489795918367346
Stephen Curry,2021.0,349,825,476,0.42303030303030303
Stephen Curry,2022.0,376,977,601,0.38485158648925283
Stephen Curry,2023.0,330,796,466,0.41457286432160806
Stephen Curry,2024.0,187,463,276,0.4038876889848812
Stephen Graham,2006.0,2,10,8,0.2
Stephen Graham,2007.0,3,11,8,0.2727272727272727
Stephen Graham,2008.0,7,14,7,0.5
Stephen Graham,2009.0,20,66,46,0.30303030303030304
Stephen Graham,2010.0,16,51,35,0.3137254901960784
Stephen Graham,2011.0,5,21,16,0.23809523809523808
Stephen Jackson,2004.0,145,427,282,0.3395784543325527
Stephen Jackson,2005.0,123,349,226,0.3524355300859599
Stephen Jackson,2006.0,123,365,242,0.336986301369863
Stephen Jackson,2007.0,126,383,257,0.3289817232375979
Stephen Jackson,2008.0,182,501,319,0.36327345309381237
Stephen Jackson,2009.0,103,305,202,0.3377049180327869
Stephen Jackson,2010.0,132,411,279,0.32116788321167883
Stephen Jackson,2011.0,121,359,238,0.3370473537604457
Stephen Jackson,2012.0,75,213,138,0.352112676056338
Stephen Jackson,2013.0,46,170,124,0.27058823529411763
Stephen Jackson,2014.0,1,14,13,0.07142857142857142
Stephon Marbury,2004.0,93,294,201,0.3163265306122449
Stephon Marbury,2005.0,115,325,210,0.35384615384615387
Stephon Marbury,2006.0,33,104,71,0.3173076923076923
Stephon Marbury,2007.0,123,345,222,0.3565217391304348
Stephon Marbury,2008.0,28,74,46,0.3783783783783784
Stephon Marbury,2009.0,9,37,28,0.24324324324324326
Sterling Brown,2018.0,33,94,61,0.35106382978723405
Sterling Brown,2019.0,60,168,108,0.35714285714285715
Sterling Brown,2020.0,44,137,93,0.32116788321167883
Sterling Brown,2021.0,91,215,124,0.4232558139534884
Sterling Brown,2022.0,28,96,68,0.2916666666666667
Sterling Brown,2023.0,0,2,2,0.0
Steve Blake,2004.0,75,202,127,0.3712871287128713
Steve Blake,2005.0,36,94,58,0.3829787234042553
Steve Blake,2006.0,76,184,108,0.41304347826086957
Steve Blake,2007.0,75,224,149,0.33482142857142855
Steve Blake,2008.0,121,298,177,0.40604026845637586
Steve Blake,2009.0,150,352,202,0.42613636363636365
Steve Blake,2010.0,116,294,178,0.3945578231292517
Steve Blake,2011.0,79,211,132,0.3744075829383886
Steve Blake,2012.0,71,201,130,0.35323383084577115
Steve Blake,2013.0,77,183,106,0.4207650273224044
Steve Blake,2014.0,82,220,138,0.37272727272727274
Steve Blake,2015.0,78,227,149,0.3436123348017621
Steve Blake,2016.0,53,153,100,0.3464052287581699
Steve Francis,2004.0,80,267,187,0.299625468164794
Steve Francis,2005.0,38,127,89,0.2992125984251969
Steve Francis,2006.0,25,83,58,0.30120481927710846
Steve Francis,2007.0,42,111,69,0.3783783783783784
Steve Francis,2008.0,4,17,13,0.23529411764705882
Steve Nash,2004.0,110,269,159,0.40892193308550184
Steve Nash,2005.0,115,272,157,0.4227941176470588
Steve Nash,2006.0,182,429,247,0.42424242424242425
Steve Nash,2007.0,175,382,207,0.4581151832460733
Steve Nash,2008.0,185,401,216,0.4613466334164589
Steve Nash,2009.0,108,246,138,0.43902439024390244
Steve Nash,2010.0,143,341,198,0.41935483870967744
Steve Nash,2011.0,81,205,124,0.3951219512195122
Steve Nash,2012.0,55,141,86,0.3900709219858156
Steve Nash,2013.0,57,133,76,0.42857142857142855
Steve Nash,2014.0,8,24,16,0.3333333333333333
Steve Novak,2007.0,13,39,26,0.3333333333333333
Steve Novak,2008.0,36,74,38,0.4864864864864865
Steve Novak,2009.0,119,286,167,0.4160839160839161
Steve Novak,2010.0,22,71,49,0.30985915492957744
Steve Novak,2011.0,26,46,20,0.5652173913043478
Steve Novak,2012.0,137,289,152,0.4740484429065744
Steve Novak,2013.0,153,360,207,0.425
Steve Novak,2014.0,52,125,73,0.416
Steve Novak,2015.0,19,48,29,0.3958333333333333
Steve Novak,2016.0,7,15,8,0.4666666666666667
Steve Novak,2017.0,1,6,5,0.16666666666666666
Steve Smith,2004.0,49,118,69,0.4152542372881356
Steve Smith,2005.0,41,105,64,0.3904761904761905
Steven Adams,2015.0,0,2,2,0.0
Steven Adams,2016.0,0,1,1,0.0
Steven Adams,2017.0,0,2,2,0.0
Steven Adams,2018.0,0,2,2,0.0
Steven Adams,2019.0,0,3,3,0.0
Steven Adams,2020.0,1,4,3,0.25
Steven Adams,2021.0,0,3,3,0.0
Steven Adams,2022.0,0,1,1,0.0
Steven Adams,2023.0,0,1,1,0.0
Steven Hunter,2005.0,0,1,1,0.0
Stromile Swift,2004.0,1,4,3,0.25
Stromile Swift,2005.0,0,4,4,0.0
Stromile Swift,2006.0,0,2,2,0.0
Stromile Swift,2007.0,0,5,5,0.0
Stromile Swift,2008.0,0,2,2,0.0
Stromile Swift,2009.0,1,1,0,1.0
Sun Yue,2009.0,0,6,6,0.0
Sundiata Gaines,2010.0,8,27,19,0.2962962962962963
Sundiata Gaines,2011.0,9,38,29,0.23684210526315788
Sundiata Gaines,2012.0,28,82,54,0.34146341463414637
Sviatoslav Mykhailiuk,2019.0,29,89,60,0.3258426966292135
Sviatoslav Mykhailiuk,2020.0,115,285,170,0.40350877192982454
Sviatoslav Mykhailiuk,2021.0,105,314,209,0.3343949044585987
Sviatoslav Mykhailiuk,2022.0,41,136,95,0.3014705882352941
Sviatoslav Mykhailiuk,2023.0,42,99,57,0.42424242424242425
Sviatoslav Mykhailiuk,2024.0,14,47,33,0.2978723404255319
T.J. Ford,2004.0,5,21,16,0.23809523809523808
T.J. Ford,2006.0,37,109,72,0.3394495412844037
T.J. Ford,2007.0,26,79,53,0.3291139240506329
T.J. Ford,2008.0,16,59,43,0.2711864406779661
T.J. Ford,2009.0,35,104,69,0.33653846153846156
T.J. Ford,2010.0,8,50,42,0.16
T.J. Ford,2011.0,7,33,26,0.21212121212121213
T.J. Ford,2012.0,2,8,6,0.25
T.J. Leaf,2018.0,18,42,24,0.42857142857142855
T.J. Leaf,2019.0,8,32,24,0.25
T.J. Leaf,2020.0,5,18,13,0.2777777777777778
T.J. McConnell,2016.0,31,89,58,0.34831460674157305
T.J. McConnell,2017.0,11,55,44,0.2
T.J. McConnell,2018.0,29,66,37,0.4393939393939394
T.J. McConnell,2019.0,14,43,29,0.32558139534883723
T.J. McConnell,2020.0,5,17,12,0.29411764705882354
T.J. McConnell,2021.0,15,49,34,0.30612244897959184
T.J. McConnell,2022.0,10,33,23,0.30303030303030304
T.J. McConnell,2023.0,26,59,33,0.4406779661016949
T.J. McConnell,2024.0,2,17,15,0.11764705882352941
T.J. Warren,2015.0,5,21,16,0.23809523809523808
T.J. Warren,2016.0,28,70,42,0.4
T.J. Warren,2017.0,26,98,72,0.2653061224489796
T.J. Warren,2018.0,20,90,70,0.2222222222222222
T.J. Warren,2019.0,77,180,103,0.42777777777777776
T.J. Warren,2020.0,98,245,147,0.4
T.J. Warren,2021.0,0,7,7,0.0
T.J. Warren,2023.0,23,74,51,0.3108108108108108
Tahjere McCall,2019.0,0,1,1,0.0
Taj Gibson,2011.0,1,9,8,0.1111111111111111
Taj Gibson,2013.0,0,6,6,0.0
Taj Gibson,2014.0,0,7,7,0.0
Taj Gibson,2016.0,0,3,3,0.0
Taj Gibson,2017.0,3,13,10,0.23076923076923078
Taj Gibson,2018.0,7,35,28,0.2
Taj Gibson,2019.0,11,34,23,0.3235294117647059
Taj Gibson,2020.0,4,14,10,0.2857142857142857
Taj Gibson,2021.0,3,15,12,0.2
Taj Gibson,2022.0,15,38,23,0.39473684210526316
Taj Gibson,2023.0,8,24,16,0.3333333333333333
Taj Gibson,2024.0,0,4,4,0.0
Talen Horton-Tucker,2020.0,6,18,12,0.3333333333333333
Talen Horton-Tucker,2021.0,39,138,99,0.2826086956521739
Talen Horton-Tucker,2022.0,49,182,133,0.2692307692307692
Talen Horton-Tucker,2023.0,58,203,145,0.2857142857142857
Talen Horton-Tucker,2024.0,37,113,76,0.3274336283185841
Tamar Slay,2004.0,4,13,9,0.3076923076923077
Tamar Slay,2005.0,2,12,10,0.16666666666666666
Tarence Kinsey,2007.0,13,46,33,0.2826086956521739
Tarence Kinsey,2008.0,3,7,4,0.42857142857142855
Tarence Kinsey,2009.0,7,18,11,0.3888888888888889
Tari Eason,2023.0,59,172,113,0.3430232558139535
Tari Eason,2024.0,18,50,32,0.36
Tarik Black,2015.0,0,1,1,0.0
Tarik Black,2017.0,1,2,1,0.5
Tarik Black,2018.0,1,11,10,0.09090909090909091
Tariq Owens,2020.0,0,2,2,0.0
Taurean Green,2008.0,2,11,9,0.18181818181818182
Taurean Prince,2017.0,37,116,79,0.31896551724137934
Taurean Prince,2018.0,176,457,281,0.3851203501094092
Taurean Prince,2019.0,123,315,192,0.3904761904761905
Taurean Prince,2020.0,146,431,285,0.33874709976798145
Taurean Prince,2021.0,62,155,93,0.4
Taurean Prince,2022.0,90,243,153,0.37037037037037035
Taurean Prince,2023.0,82,215,133,0.3813953488372093
Taurean Prince,2024.0,94,241,147,0.3900414937759336
Taylor Griffin,2010.0,0,2,2,0.0
Taylor Hendricks,2024.0,14,37,23,0.3783783783783784
Tayshaun Prince,2004.0,70,206,136,0.33980582524271846
Tayshaun Prince,2005.0,69,198,129,0.3484848484848485
Tayshaun Prince,2006.0,85,229,144,0.37117903930131
Tayshaun Prince,2007.0,99,254,155,0.38976377952755903
Tayshaun Prince,2008.0,61,171,110,0.3567251461988304
Tayshaun Prince,2009.0,57,146,89,0.3904109589041096
Tayshaun Prince,2010.0,27,73,46,0.3698630136986301
Tayshaun Prince,2011.0,34,98,64,0.3469387755102041
Tayshaun Prince,2012.0,37,104,67,0.3557692307692308
Tayshaun Prince,2013.0,43,113,70,0.3805309734513274
Tayshaun Prince,2014.0,21,73,52,0.2876712328767123
Tayshaun Prince,2015.0,31,67,36,0.4626865671641791
Tayshaun Prince,2016.0,4,23,19,0.17391304347826086
Taze Moore,2024.0,0,2,2,0.0
Terance Mann,2020.0,7,22,15,0.3181818181818182
Terance Mann,2021.0,54,128,74,0.421875
Terance Mann,2022.0,76,210,134,0.3619047619047619
Terance Mann,2023.0,86,217,131,0.39631336405529954
Terance Mann,2024.0,35,116,81,0.3017241379310345
Terence Davis,2020.0,102,261,159,0.39080459770114945
Terence Davis,2021.0,98,267,169,0.36704119850187267
Terence Davis,2022.0,49,149,100,0.3288590604026846
Terence Davis,2023.0,95,260,165,0.36538461538461536
Terence Morris,2006.0,0,2,2,0.0
Terquavion Smith,2024.0,2,6,4,0.3333333333333333
Terrance Ferguson,2018.0,41,121,80,0.33884297520661155
Terrance Ferguson,2019.0,113,308,195,0.36688311688311687
Terrance Ferguson,2020.0,51,178,127,0.28651685393258425
Terrance Ferguson,2021.0,0,5,5,0.0
Terrel Harris,2012.0,8,40,32,0.2
Terrel Harris,2013.0,0,8,8,0.0
Terrence Jones,2013.0,5,21,16,0.23809523809523808
Terrence Jones,2014.0,31,102,71,0.30392156862745096
Terrence Jones,2015.0,16,56,40,0.2857142857142857
Terrence Jones,2016.0,25,79,54,0.31645569620253167
Terrence Jones,2017.0,19,75,56,0.25333333333333335
Terrence Jones,2019.0,0,2,2,0.0
Terrence Ross,2013.0,65,196,131,0.33163265306122447
Terrence Ross,2014.0,165,432,267,0.3819444444444444
Terrence Ross,2015.0,151,408,257,0.3700980392156863
Terrence Ross,2016.0,152,403,251,0.3771712158808933
Terrence Ross,2017.0,138,387,249,0.35658914728682173
Terrence Ross,2018.0,30,93,63,0.3225806451612903
Terrence Ross,2019.0,229,601,372,0.3810316139767055
Terrence Ross,2020.0,187,534,347,0.350187265917603
Terrence Ross,2021.0,89,264,175,0.3371212121212121
Terrence Ross,2022.0,77,264,187,0.2916666666666667
Terrence Ross,2023.0,101,280,179,0.3607142857142857
Terrence Williams,2010.0,31,100,69,0.31
Terrence Williams,2011.0,6,22,16,0.2727272727272727
Terrence Williams,2012.0,16,46,30,0.34782608695652173
Terrence Williams,2013.0,5,18,13,0.2777777777777778
Terry Rozier,2016.0,10,38,28,0.2631578947368421
Terry Rozier,2017.0,71,218,147,0.3256880733944954
Terry Rozier,2018.0,204,549,345,0.37158469945355194
Terry Rozier,2019.0,127,371,244,0.3423180592991914
Terry Rozier,2020.0,172,425,253,0.4047058823529412
Terry Rozier,2021.0,222,580,358,0.38275862068965516
Terry Rozier,2022.0,224,602,378,0.37209302325581395
Terry Rozier,2023.0,165,507,342,0.3254437869822485
Terry Rozier,2024.0,85,243,158,0.3497942386831276
Terry Taylor,2022.0,12,38,26,0.3157894736842105
Terry Taylor,2023.0,5,19,14,0.2631578947368421
Terry Taylor,2024.0,0,5,5,0.0
Thabo Sefolosha,2007.0,18,50,32,0.36
Thabo Sefolosha,2008.0,29,88,59,0.32954545454545453
Thabo Sefolosha,2009.0,24,87,63,0.27586206896551724
Thabo Sefolosha,2010.0,44,144,100,0.3055555555555556
Thabo Sefolosha,2011.0,32,128,96,0.25
Thabo Sefolosha,2012.0,47,120,73,0.39166666666666666
Thabo Sefolosha,2013.0,120,296,176,0.40540540540540543
Thabo Sefolosha,2014.0,54,175,121,0.30857142857142855
Thabo Sefolosha,2015.0,25,78,53,0.32051282051282054
Thabo Sefolosha,2016.0,49,143,94,0.34265734265734266
Thabo Sefolosha,2017.0,41,120,79,0.3416666666666667
Thabo Sefolosha,2018.0,32,84,52,0.38095238095238093
Thabo Sefolosha,2019.0,35,86,51,0.4069767441860465
Thabo Sefolosha,2020.0,15,54,39,0.2777777777777778
Thaddeus Young,2008.0,7,23,16,0.30434782608695654
Thaddeus Young,2009.0,61,176,115,0.3465909090909091
Thaddeus Young,2010.0,48,138,90,0.34782608695652173
Thaddeus Young,2011.0,6,23,17,0.2608695652173913
Thaddeus Young,2012.0,1,4,3,0.25
Thaddeus Young,2013.0,1,8,7,0.125
Thaddeus Young,2014.0,90,292,202,0.3082191780821918
Thaddeus Young,2015.0,38,119,81,0.31932773109243695
Thaddeus Young,2016.0,7,30,23,0.23333333333333334
Thaddeus Young,2017.0,46,122,76,0.3770491803278688
Thaddeus Young,2018.0,60,188,128,0.3191489361702128
Thaddeus Young,2019.0,53,154,101,0.34415584415584416
Thaddeus Young,2020.0,79,223,144,0.3542600896860987
Thaddeus Young,2021.0,12,45,33,0.26666666666666666
Thaddeus Young,2022.0,18,55,37,0.32727272727272727
Thaddeus Young,2023.0,6,34,28,0.17647058823529413
Thaddeus Young,2024.0,1,4,3,0.25
Thanasis Antetokounmpo,2016.0,0,1,1,0.0
Thanasis Antetokounmpo,2020.0,0,10,10,0.0
Thanasis Antetokounmpo,2021.0,7,29,22,0.2413793103448276
Thanasis Antetokounmpo,2022.0,2,14,12,0.14285714285714285
Thanasis Antetokounmpo,2023.0,0,8,8,0.0
Theo Maledon,2021.0,105,313,208,0.3354632587859425
Theo Maledon,2022.0,44,150,106,0.29333333333333333
Theo Maledon,2023.0,28,95,67,0.29473684210526313
Theo Maledon,2024.0,5,30,25,0.16666666666666666
Theo Pinson,2019.0,15,53,38,0.2830188679245283
Theo Pinson,2020.0,15,80,65,0.1875
Theo Pinson,2021.0,0,8,8,0.0
Theo Pinson,2022.0,10,30,20,0.3333333333333333
Theo Pinson,2023.0,22,62,40,0.3548387096774194
Theo Ratliff,2008.0,0,1,1,0.0
Theron Smith,2004.0,6,12,6,0.5
Theron Smith,2005.0,3,12,9,0.25
Thomas Bryant,2018.0,1,10,9,0.1
Thomas Bryant,2019.0,33,99,66,0.3333333333333333
Thomas Bryant,2020.0,37,91,54,0.4065934065934066
Thomas Bryant,2021.0,9,21,12,0.42857142857142855
Thomas Bryant,2022.0,12,42,30,0.2857142857142857
Thomas Bryant,2023.0,26,59,33,0.4406779661016949
Thomas Bryant,2024.0,0,4,4,0.0
Thomas Gardner,2008.0,3,12,9,0.25
Thomas Gardner,2009.0,7,29,22,0.2413793103448276
Thomas Robinson,2013.0,0,1,1,0.0
Thomas Robinson,2014.0,0,1,1,0.0
Thomas Robinson,2015.0,0,2,2,0.0
Thomas Robinson,2016.0,0,1,1,0.0
Thomas Robinson,2017.0,0,1,1,0.0
Thomas Welsh,2019.0,3,7,4,0.42857142857142855
Thon Maker,2017.0,30,84,54,0.35714285714285715
Thon Maker,2018.0,37,124,87,0.29838709677419356
Thon Maker,2019.0,49,165,116,0.296969696969697
Thon Maker,2020.0,22,64,42,0.34375
Thon Maker,2021.0,0,2,2,0.0
Tiago Splitter,2011.0,0,1,1,0.0
Tiago Splitter,2013.0,0,3,3,0.0
Tiago Splitter,2014.0,0,4,4,0.0
Tiago Splitter,2016.0,0,2,2,0.0
Tiago Splitter,2017.0,2,6,4,0.3333333333333333
Tibor Pleiss,2016.0,0,2,2,0.0
Tierre Brown,2005.0,26,72,46,0.3611111111111111
Tim Duncan,2004.0,2,13,11,0.15384615384615385
Tim Duncan,2005.0,4,14,10,0.2857142857142857
Tim Duncan,2006.0,2,7,5,0.2857142857142857
Tim Duncan,2007.0,1,9,8,0.1111111111111111
Tim Duncan,2008.0,1,9,8,0.1111111111111111
Tim Duncan,2009.0,0,2,2,0.0
Tim Duncan,2010.0,3,13,10,0.23076923076923078
Tim Duncan,2011.0,0,4,4,0.0
Tim Duncan,2012.0,0,5,5,0.0
Tim Duncan,2013.0,2,8,6,0.25
Tim Duncan,2014.0,0,7,7,0.0
Tim Duncan,2015.0,2,8,6,0.25
Tim Duncan,2016.0,0,2,2,0.0
Tim Frazier,2015.0,5,17,12,0.29411764705882354
Tim Frazier,2016.0,16,48,32,0.3333333333333333
Tim Frazier,2017.0,40,128,88,0.3125
Tim Frazier,2018.0,17,56,39,0.30357142857142855
Tim Frazier,2019.0,40,107,67,0.37383177570093457
Tim Frazier,2020.0,10,30,20,0.3333333333333333
Tim Frazier,2021.0,0,8,8,0.0
Tim Frazier,2022.0,6,17,11,0.35294117647058826
Tim Hardaway,2014.0,130,358,228,0.36312849162011174
Tim Hardaway,2015.0,121,354,233,0.3418079096045198
Tim Hardaway,2016.0,50,156,106,0.32051282051282054
Tim Hardaway,2017.0,160,459,299,0.3485838779956427
Tim Hardaway,2018.0,130,410,280,0.3170731707317073
Tim Hardaway,2019.0,162,477,315,0.33962264150943394
Tim Hardaway,2020.0,223,567,344,0.3932980599647266
Tim Hardaway,2021.0,230,586,356,0.3924914675767918
Tim Hardaway,2022.0,102,304,202,0.3355263157894737
Tim Hardaway,2023.0,212,550,338,0.38545454545454544
Tim Hardaway,2024.0,140,383,243,0.36553524804177545
Tim Quarterman,2017.0,6,13,7,0.46153846153846156
Tim Quarterman,2018.0,0,2,2,0.0
Tim Thomas,2004.0,73,195,122,0.37435897435897436
Tim Thomas,2005.0,85,208,123,0.40865384615384615
Tim Thomas,2006.0,94,219,125,0.4292237442922374
Tim Thomas,2007.0,136,356,220,0.38202247191011235
Tim Thomas,2008.0,83,271,188,0.3062730627306273
Tim Thomas,2009.0,79,193,114,0.40932642487046633
Tim Thomas,2010.0,16,43,27,0.37209302325581395
Timofey Mozgov,2013.0,0,2,2,0.0
Timofey Mozgov,2014.0,4,24,20,0.16666666666666666
Timofey Mozgov,2015.0,2,6,4,0.3333333333333333
Timofey Mozgov,2016.0,1,7,6,0.14285714285714285
Timofey Mozgov,2017.0,0,1,1,0.0
Timofey Mozgov,2018.0,4,18,14,0.2222222222222222
Timothe Luwawu-Cabarrot,2017.0,50,161,111,0.3105590062111801
Timothe Luwawu-Cabarrot,2018.0,53,158,105,0.33544303797468356
Timothe Luwawu-Cabarrot,2019.0,36,116,80,0.3103448275862069
Timothe Luwawu-Cabarrot,2020.0,75,199,124,0.3768844221105528
Timothe Luwawu-Cabarrot,2021.0,77,245,168,0.3142857142857143
Timothe Luwawu-Cabarrot,2022.0,47,127,80,0.3700787401574803
Tobias Harris,2012.0,6,23,17,0.2608695652173913
Tobias Harris,2013.0,34,108,74,0.3148148148148148
Tobias Harris,2014.0,32,126,94,0.25396825396825395
Tobias Harris,2015.0,87,239,152,0.36401673640167365
Tobias Harris,2016.0,84,251,167,0.3346613545816733
Tobias Harris,2017.0,109,314,205,0.3471337579617834
Tobias Harris,2018.0,183,445,262,0.41123595505617977
Tobias Harris,2019.0,178,456,278,0.39035087719298245
Tobias Harris,2020.0,133,372,239,0.3575268817204301
Tobias Harris,2021.0,98,251,153,0.3904382470119522
Tobias Harris,2022.0,123,332,209,0.3704819277108434
Tobias Harris,2023.0,141,365,224,0.3863013698630137
Tobias Harris,2024.0,51,142,91,0.3591549295774648
Tom Gugliotta,2004.0,1,4,3,0.25
Tom Gugliotta,2005.0,8,26,18,0.3076923076923077
Tomas Satoransky,2017.0,9,37,28,0.24324324324324326
Tomas Satoransky,2018.0,47,104,57,0.4519230769230769
Tomas Satoransky,2019.0,64,163,99,0.39263803680981596
Tomas Satoransky,2020.0,64,199,135,0.32160804020100503
Tomas Satoransky,2021.0,42,118,76,0.3559322033898305
Tomas Satoransky,2022.0,11,53,42,0.20754716981132076
Toney Douglas,2010.0,68,175,107,0.38857142857142857
Toney Douglas,2011.0,150,401,251,0.3740648379052369
Toney Douglas,2012.0,27,117,90,0.23076923076923078
Toney Douglas,2013.0,82,216,134,0.37962962962962965
Toney Douglas,2014.0,34,108,74,0.3148148148148148
Toney Douglas,2015.0,5,18,13,0.2777777777777778
Toney Douglas,2016.0,81,203,122,0.39901477832512317
Toney Douglas,2017.0,7,39,32,0.1794871794871795
Toni Kukoc,2004.0,53,180,127,0.29444444444444445
Toni Kukoc,2005.0,42,116,74,0.3620689655172414
Toni Kukoc,2006.0,50,155,105,0.3225806451612903
Tony Allen,2005.0,12,31,19,0.3870967741935484
Tony Allen,2006.0,11,34,23,0.3235294117647059
Tony Allen,2007.0,8,33,25,0.24242424242424243
Tony Allen,2008.0,18,58,40,0.3103448275862069
Tony Allen,2009.0,6,27,21,0.2222222222222222
Tony Allen,2010.0,0,10,10,0.0
Tony Allen,2011.0,5,30,25,0.16666666666666666
Tony Allen,2012.0,8,31,23,0.25806451612903225
Tony Allen,2013.0,5,32,27,0.15625
Tony Allen,2014.0,11,54,43,0.2037037037037037
Tony Allen,2015.0,11,36,25,0.3055555555555556
Tony Allen,2016.0,16,49,33,0.32653061224489793
Tony Allen,2017.0,15,53,38,0.2830188679245283
Tony Allen,2018.0,4,12,8,0.3333333333333333
Tony Battie,2004.0,2,9,7,0.2222222222222222
Tony Battie,2005.0,0,6,6,0.0
Tony Battie,2006.0,0,6,6,0.0
Tony Battie,2007.0,0,1,1,0.0
Tony Battie,2009.0,2,9,7,0.2222222222222222
Tony Battie,2010.0,1,4,3,0.25
Tony Battie,2011.0,2,3,1,0.6666666666666666
Tony Battie,2012.0,0,1,1,0.0
Tony Bobbitt,2005.0,1,2,1,0.5
Tony Bradley,2018.0,0,1,1,0.0
Tony Bradley,2020.0,3,3,0,1.0
Tony Bradley,2021.0,0,3,3,0.0
Tony Bradley,2023.0,3,5,2,0.6
Tony Delk,2004.0,19,63,44,0.30158730158730157
Tony Delk,2005.0,72,202,130,0.3564356435643564
Tony Delk,2006.0,23,62,39,0.3709677419354839
Tony Massenburg,2004.0,0,1,1,0.0
Tony Mitchell,2014.0,1,2,1,0.5
Tony Parker,2004.0,79,242,163,0.32644628099173556
Tony Parker,2005.0,52,204,152,0.2549019607843137
Tony Parker,2006.0,13,45,32,0.28888888888888886
Tony Parker,2007.0,22,59,37,0.3728813559322034
Tony Parker,2008.0,24,86,62,0.27906976744186046
Tony Parker,2009.0,22,79,57,0.27848101265822783
Tony Parker,2010.0,12,37,25,0.32432432432432434
Tony Parker,2011.0,26,78,52,0.3333333333333333
Tony Parker,2012.0,21,82,61,0.25609756097560976
Tony Parker,2013.0,35,99,64,0.35353535353535354
Tony Parker,2014.0,38,102,64,0.37254901960784315
Tony Parker,2015.0,38,98,60,0.3877551020408163
Tony Parker,2016.0,31,81,50,0.38271604938271603
Tony Parker,2017.0,34,88,54,0.38636363636363635
Tony Parker,2018.0,10,42,32,0.23809523809523808
Tony Parker,2019.0,13,51,38,0.2549019607843137
Tony Snell,2014.0,57,183,126,0.3114754098360656
Tony Snell,2015.0,82,224,142,0.36607142857142855
Tony Snell,2016.0,56,155,99,0.36129032258064514
Tony Snell,2017.0,160,386,226,0.41450777202072536
Tony Snell,2018.0,113,289,176,0.39100346020761245
Tony Snell,2019.0,82,206,124,0.39805825242718446
Tony Snell,2020.0,102,254,152,0.4015748031496063
Tony Snell,2021.0,63,120,57,0.525
Tony Snell,2022.0,45,129,84,0.3488372093023256
Tony Wroten,2013.0,4,18,14,0.2222222222222222
Tony Wroten,2014.0,40,188,148,0.2127659574468085
Tony Wroten,2015.0,37,142,105,0.2605633802816901
Tony Wroten,2016.0,3,17,14,0.17647058823529413
Tornike Shengelia,2013.0,1,2,1,0.5
Tornike Shengelia,2014.0,0,6,6,0.0
Torrey Craig,2018.0,17,58,41,0.29310344827586204
Torrey Craig,2019.0,78,224,146,0.3482142857142857
Torrey Craig,2020.0,56,180,124,0.3111111111111111
Torrey Craig,2021.0,54,143,89,0.3776223776223776
Torrey Craig,2022.0,80,243,163,0.3292181069958848
Torrey Craig,2023.0,111,279,168,0.3978494623655914
Torrey Craig,2024.0,29,76,47,0.3815789473684211
Toumani Camara,2024.0,27,107,80,0.2523364485981308
Toure' Murry,2014.0,5,12,7,0.4166666666666667
Tracy McGrady,2004.0,174,513,339,0.3391812865497076
Tracy McGrady,2005.0,159,481,322,0.3305613305613306
Tracy McGrady,2006.0,73,234,161,0.31196581196581197
Tracy McGrady,2007.0,135,417,282,0.3237410071942446
Tracy McGrady,2008.0,91,319,228,0.2852664576802508
Tracy McGrady,2009.0,44,117,73,0.37606837606837606
Tracy McGrady,2010.0,16,64,48,0.25
Tracy McGrady,2011.0,30,88,58,0.3409090909090909
Tracy McGrady,2012.0,15,37,22,0.40540540540540543
Tracy McGrady,2013.0,0,3,3,0.0
Tracy Murray,2004.0,2,5,3,0.4
Trae Young,2019.0,156,482,326,0.3236514522821577
Trae Young,2020.0,205,568,363,0.3609154929577465
Trae Young,2021.0,181,541,360,0.3345656192236599
Trae Young,2022.0,245,667,422,0.36731634182908546
Trae Young,2023.0,172,514,342,0.3346303501945525
Trae Young,2024.0,131,363,232,0.3608815426997245
Travis Best,2004.0,3,19,16,0.15789473684210525
Travis Best,2005.0,27,94,67,0.2872340425531915
Travis Diener,2006.0,25,57,32,0.43859649122807015
Travis Diener,2007.0,18,50,32,0.36
Travis Diener,2008.0,74,233,159,0.31759656652360513
Travis Diener,2009.0,46,118,72,0.3898305084745763
Travis Diener,2010.0,1,7,6,0.14285714285714285
Travis Hansen,2004.0,9,30,21,0.3
Travis Outlaw,2005.0,4,10,6,0.4
Travis Outlaw,2006.0,14,53,39,0.2641509433962264
Travis Outlaw,2007.0,10,37,27,0.2702702702702703
Travis Outlaw,2008.0,40,101,61,0.39603960396039606
Travis Outlaw,2009.0,93,252,159,0.36904761904761907
Travis Outlaw,2010.0,40,105,65,0.38095238095238093
Travis Outlaw,2011.0,76,252,176,0.30158730158730157
Travis Outlaw,2012.0,16,60,44,0.26666666666666666
Travis Outlaw,2013.0,14,50,36,0.28
Travis Outlaw,2014.0,41,117,76,0.3504273504273504
Travis Wear,2015.0,11,30,19,0.36666666666666664
Travis Wear,2018.0,17,47,30,0.3617021276595745
Trayce Jackson-Davis,2024.0,0,2,2,0.0
Tre Jones,2021.0,3,5,2,0.6
Tre Jones,2022.0,11,53,42,0.20754716981132076
Tre Jones,2023.0,45,158,113,0.2848101265822785
Tre Jones,2024.0,26,91,65,0.2857142857142857
Tre Mann,2022.0,98,272,174,0.3602941176470588
Tre Mann,2023.0,81,257,176,0.3151750972762646
Tre Mann,2024.0,8,19,11,0.42105263157894735
Tre Scott,2022.0,0,1,1,0.0
Tremaine Fowlkes,2004.0,1,8,7,0.125
Tremaine Fowlkes,2005.0,1,3,2,0.3333333333333333
Tremont Waters,2020.0,4,25,21,0.16
Tremont Waters,2021.0,15,41,26,0.36585365853658536
Tremont Waters,2022.0,2,9,7,0.2222222222222222
Trendon Watford,2022.0,9,38,29,0.23684210526315788
Trendon Watford,2023.0,25,64,39,0.390625
Trendon Watford,2024.0,10,28,18,0.35714285714285715
Trent Forrest,2021.0,5,26,21,0.19230769230769232
Trent Forrest,2022.0,5,27,22,0.18518518518518517
Trent Forrest,2023.0,0,2,2,0.0
Trent Forrest,2024.0,2,7,5,0.2857142857142857
Trenton Hassell,2004.0,5,15,10,0.3333333333333333
Trenton Hassell,2005.0,1,11,10,0.09090909090909091
Trenton Hassell,2006.0,7,23,16,0.30434782608695654
Trenton Hassell,2007.0,6,25,19,0.24
Trenton Hassell,2008.0,2,9,7,0.2222222222222222
Trenton Hassell,2009.0,2,8,6,0.25
Trenton Hassell,2010.0,0,5,5,0.0
Trevelin Queen,2022.0,9,24,15,0.375
Trevelin Queen,2023.0,2,15,13,0.13333333333333333
Trevelin Queen,2024.0,3,16,13,0.1875
Treveon Graham,2017.0,9,15,6,0.6
Treveon Graham,2018.0,40,97,57,0.41237113402061853
Treveon Graham,2019.0,38,135,97,0.2814814814814815
Treveon Graham,2020.0,33,120,87,0.275
Trevon Duval,2019.0,1,1,0,1.0
Trevor Ariza,2005.0,3,13,10,0.23076923076923078
Trevor Ariza,2006.0,1,5,4,0.2
Trevor Ariza,2007.0,0,7,7,0.0
Trevor Ariza,2008.0,6,22,16,0.2727272727272727
Trevor Ariza,2009.0,101,275,174,0.36727272727272725
Trevor Ariza,2010.0,136,407,271,0.33415233415233414
Trevor Ariza,2011.0,89,292,203,0.3047945205479452
Trevor Ariza,2012.0,29,87,58,0.3333333333333333
Trevor Ariza,2013.0,76,209,133,0.36363636363636365
Trevor Ariza,2014.0,205,498,293,0.41164658634538154
Trevor Ariza,2015.0,230,651,421,0.3533026113671275
Trevor Ariza,2016.0,189,527,338,0.3586337760910816
Trevor Ariza,2017.0,213,614,401,0.3469055374592834
Trevor Ariza,2018.0,196,553,357,0.35443037974683544
Trevor Ariza,2019.0,145,434,289,0.33410138248847926
Trevor Ariza,2020.0,77,207,130,0.3719806763285024
Trevor Ariza,2021.0,55,160,105,0.34375
Trevor Ariza,2022.0,20,74,54,0.2702702702702703
Trevor Booker,2011.0,0,1,1,0.0
Trevor Booker,2012.0,1,2,1,0.5
Trevor Booker,2013.0,0,5,5,0.0
Trevor Booker,2014.0,0,4,4,0.0
Trevor Booker,2015.0,29,84,55,0.34523809523809523
Trevor Booker,2016.0,12,41,29,0.2926829268292683
Trevor Booker,2017.0,25,78,53,0.32051282051282054
Trevor Booker,2018.0,8,35,27,0.22857142857142856
Trevor Hudgins,2023.0,2,8,6,0.25
Trevor Keels,2023.0,1,4,3,0.25
Trey Burke,2014.0,111,336,225,0.33035714285714285
Trey Burke,2015.0,124,390,266,0.31794871794871793
Trey Burke,2016.0,88,256,168,0.34375
Trey Burke,2017.0,31,72,41,0.4305555555555556
Trey Burke,2018.0,38,105,67,0.3619047619047619
Trey Burke,2019.0,56,160,104,0.35
Trey Burke,2020.0,40,92,52,0.43478260869565216
Trey Burke,2021.0,58,167,109,0.3473053892215569
Trey Burke,2022.0,30,92,62,0.32608695652173914
Trey Johnson,2011.0,1,4,3,0.25
Trey Lyles,2016.0,49,128,79,0.3828125
Trey Lyles,2017.0,66,207,141,0.3188405797101449
Trey Lyles,2018.0,83,218,135,0.38073394495412843
Trey Lyles,2019.0,51,201,150,0.2537313432835821
Trey Lyles,2020.0,65,168,103,0.3869047619047619
Trey Lyles,2021.0,14,40,26,0.35
Trey Lyles,2022.0,67,209,142,0.32057416267942584
Trey Lyles,2023.0,96,267,171,0.3595505617977528
Trey Lyles,2024.0,45,116,71,0.3879310344827586
Trey Murphy,2022.0,84,214,130,0.3925233644859813
Trey Murphy,2023.0,202,497,295,0.40643863179074446
Trey Murphy,2024.0,53,146,93,0.363013698630137
Trey Thompkins,2012.0,4,13,9,0.3076923076923077
Tristan Thompson,2012.0,0,2,2,0.0
Tristan Thompson,2013.0,0,3,3,0.0
Tristan Thompson,2014.0,0,1,1,0.0
Tristan Thompson,2017.0,0,3,3,0.0
Tristan Thompson,2018.0,0,1,1,0.0
Tristan Thompson,2020.0,9,23,14,0.391304347826087
Tristan Thompson,2021.0,0,3,3,0.0
Tristan Thompson,2022.0,1,3,2,0.3333333333333333
Tristan Thompson,2024.0,0,1,1,0.0
Troy Bell,2004.0,0,4,4,0.0
Troy Brown,2019.0,22,69,47,0.3188405797101449
Troy Brown,2020.0,61,179,118,0.3407821229050279
Troy Brown,2021.0,22,70,48,0.3142857142857143
Troy Brown,2022.0,49,144,95,0.3402777777777778
Troy Brown,2023.0,109,296,187,0.36824324324324326
Troy Brown,2024.0,30,81,51,0.37037037037037035
Troy Caupain,2019.0,2,3,1,0.6666666666666666
Troy Daniels,2014.0,20,40,20,0.5
Troy Daniels,2015.0,43,118,75,0.3644067796610169
Troy Daniels,2016.0,59,125,66,0.472
Troy Daniels,2017.0,141,363,222,0.3884297520661157
Troy Daniels,2018.0,183,458,275,0.39956331877729256
Troy Daniels,2019.0,74,194,120,0.38144329896907214
Troy Daniels,2020.0,49,138,89,0.35507246376811596
Troy Hudson,2004.0,31,77,46,0.4025974025974026
Troy Hudson,2005.0,89,258,169,0.3449612403100775
Troy Hudson,2006.0,40,101,61,0.39603960396039606
Troy Hudson,2007.0,28,80,52,0.35
Troy Hudson,2008.0,4,12,8,0.3333333333333333
Troy Murphy,2004.0,5,17,12,0.29411764705882354
Troy Murphy,2005.0,59,148,89,0.39864864864864863
Troy Murphy,2006.0,58,181,123,0.32044198895027626
Troy Murphy,2007.0,58,147,89,0.3945578231292517
Troy Murphy,2008.0,94,236,142,0.3983050847457627
Troy Murphy,2009.0,161,358,197,0.44972067039106145
Troy Murphy,2010.0,128,333,205,0.3843843843843844
Troy Murphy,2011.0,5,33,28,0.15151515151515152
Troy Murphy,2012.0,29,68,39,0.4264705882352941
Troy Murphy,2013.0,11,35,24,0.3142857142857143
Troy Williams,2017.0,18,67,49,0.26865671641791045
Troy Williams,2018.0,11,38,27,0.2894736842105263
Troy Williams,2019.0,14,44,30,0.3181818181818182
Ty Jerome,2020.0,14,50,36,0.28
Ty Jerome,2021.0,71,168,97,0.4226190476190476
Ty Jerome,2022.0,54,186,132,0.2903225806451613
Ty Jerome,2023.0,35,90,55,0.3888888888888889
Ty Jerome,2024.0,0,1,1,0.0
Ty Lawson,2010.0,38,93,55,0.40860215053763443
Ty Lawson,2011.0,74,182,108,0.4065934065934066
Ty Lawson,2012.0,82,228,146,0.35964912280701755
Ty Lawson,2013.0,89,253,164,0.35177865612648224
Ty Lawson,2014.0,72,202,130,0.3564356435643564
Ty Lawson,2015.0,70,205,135,0.34146341463414637
Ty Lawson,2016.0,36,111,75,0.32432432432432434
Ty Lawson,2017.0,34,119,85,0.2857142857142857
Ty Lawson,2018.0,5,8,3,0.625
Ty-Shon Alexander,2021.0,2,9,7,0.2222222222222222
TyTy Washington,2023.0,19,80,61,0.2375
TyTy Washington,2024.0,0,1,1,0.0
Tyler Bey,2021.0,1,4,3,0.25
Tyler Cavanaugh,2018.0,32,89,57,0.3595505617977528
Tyler Cavanaugh,2019.0,1,5,4,0.2
Tyler Cook,2021.0,1,2,1,0.5
Tyler Dorsey,2018.0,72,200,128,0.36
Tyler Dorsey,2019.0,44,132,88,0.3333333333333333
Tyler Dorsey,2023.0,1,2,1,0.5
Tyler Ennis,2015.0,13,48,35,0.2708333333333333
Tyler Ennis,2016.0,13,39,26,0.3333333333333333
Tyler Ennis,2017.0,27,70,43,0.38571428571428573
Tyler Ennis,2018.0,14,56,42,0.25
Tyler Hansbrough,2010.0,0,4,4,0.0
Tyler Hansbrough,2011.0,0,2,2,0.0
Tyler Hansbrough,2012.0,0,1,1,0.0
Tyler Hansbrough,2013.0,0,3,3,0.0
Tyler Hansbrough,2014.0,0,2,2,0.0
Tyler Hansbrough,2015.0,1,7,6,0.14285714285714285
Tyler Hansbrough,2016.0,2,3,1,0.6666666666666666
Tyler Herro,2020.0,164,426,262,0.38497652582159625
Tyler Herro,2021.0,113,316,203,0.3575949367088608
Tyler Herro,2022.0,191,509,318,0.37524557956778
Tyler Herro,2023.0,205,541,336,0.3789279112754159
Tyler Herro,2024.0,90,224,134,0.4017857142857143
Tyler Honeycutt,2012.0,1,3,2,0.3333333333333333
Tyler Honeycutt,2013.0,0,2,2,0.0
Tyler Johnson,2015.0,18,48,30,0.375
Tyler Johnson,2016.0,30,77,47,0.38961038961038963
Tyler Johnson,2017.0,93,249,156,0.37349397590361444
Tyler Johnson,2018.0,125,334,209,0.37425149700598803
Tyler Johnson,2019.0,90,260,170,0.34615384615384615
Tyler Johnson,2020.0,49,147,98,0.3333333333333333
Tyler Johnson,2021.0,51,143,92,0.35664335664335667
Tyler Johnson,2022.0,5,13,8,0.38461538461538464
Tyler Lydon,2019.0,4,10,6,0.4
Tyler Ulis,2017.0,21,79,58,0.26582278481012656
Tyler Ulis,2018.0,42,146,104,0.2876712328767123
Tyler Zeller,2013.0,0,4,4,0.0
Tyler Zeller,2014.0,0,1,1,0.0
Tyler Zeller,2017.0,0,1,1,0.0
Tyler Zeller,2018.0,10,28,18,0.35714285714285715
Tyler Zeller,2019.0,0,1,1,0.0
Tyreke Evans,2010.0,36,141,105,0.2553191489361702
Tyreke Evans,2011.0,43,148,105,0.2905405405405405
Tyreke Evans,2012.0,20,99,79,0.20202020202020202
Tyreke Evans,2013.0,45,133,88,0.3383458646616541
Tyreke Evans,2014.0,21,95,74,0.22105263157894736
Tyreke Evans,2015.0,71,238,167,0.29831932773109243
Tyreke Evans,2016.0,33,85,52,0.38823529411764707
Tyreke Evans,2017.0,42,118,76,0.3559322033898305
Tyreke Evans,2018.0,114,286,172,0.3986013986013986
Tyreke Evans,2019.0,88,236,148,0.3728813559322034
Tyrell Terry,2021.0,0,7,7,0.0
Tyrese Haliburton,2021.0,121,296,175,0.40878378378378377
Tyrese Haliburton,2022.0,161,389,228,0.4138817480719794
Tyrese Haliburton,2023.0,161,402,241,0.40049751243781095
Tyrese Haliburton,2024.0,116,293,177,0.39590443686006827
Tyrese Martin,2023.0,1,7,6,0.14285714285714285
Tyrese Maxey,2021.0,35,115,80,0.30434782608695654
Tyrese Maxey,2022.0,158,378,220,0.41798941798941797
Tyrese Maxey,2023.0,194,455,261,0.42637362637362636
Tyrese Maxey,2024.0,129,346,217,0.37283236994219654
Tyrone Wallace,2018.0,10,40,30,0.25
Tyrone Wallace,2019.0,4,19,15,0.21052631578947367
Tyrone Wallace,2020.0,1,15,14,0.06666666666666667
Tyrone Wallace,2022.0,2,8,6,0.25
Tyronn Lue,2004.0,80,209,129,0.3827751196172249
Tyronn Lue,2005.0,55,155,100,0.3548387096774194
Tyronn Lue,2006.0,58,126,68,0.4603174603174603
Tyronn Lue,2007.0,56,161,105,0.34782608695652173
Tyronn Lue,2008.0,39,86,47,0.45348837209302323
Tyronn Lue,2009.0,28,63,35,0.4444444444444444
Tyrus Thomas,2007.0,0,2,2,0.0
Tyrus Thomas,2008.0,1,6,5,0.16666666666666666
Tyrus Thomas,2009.0,3,10,7,0.3
Tyrus Thomas,2010.0,0,3,3,0.0
Tyrus Thomas,2011.0,0,3,3,0.0
Tyrus Thomas,2012.0,1,3,2,0.3333333333333333
Tyrus Thomas,2013.0,3,8,5,0.375
Tyshawn Taylor,2013.0,6,13,7,0.46153846153846156
Tyshawn Taylor,2014.0,3,12,9,0.25
Tyson Chandler,2004.0,0,1,1,0.0
Tyson Chandler,2005.0,0,2,2,0.0
Tyson Chandler,2006.0,0,1,1,0.0
Tyson Chandler,2007.0,0,1,1,0.0
Tyson Chandler,2008.0,0,1,1,0.0
Tyson Chandler,2012.0,0,2,2,0.0
Tyson Chandler,2014.0,0,1,1,0.0
Tyson Chandler,2016.0,0,1,1,0.0
Tyson Chandler,2019.0,0,1,1,0.0
Tyus Jones,2016.0,16,53,37,0.3018867924528302
Tyus Jones,2017.0,26,73,47,0.3561643835616438
Tyus Jones,2018.0,45,131,86,0.3435114503816794
Tyus Jones,2019.0,40,126,86,0.31746031746031744
Tyus Jones,2020.0,47,124,77,0.3790322580645161
Tyus Jones,2021.0,47,146,99,0.3219178082191781
Tyus Jones,2022.0,98,250,152,0.392
Tyus Jones,2023.0,124,345,221,0.35942028985507246
Tyus Jones,2024.0,70,169,99,0.41420118343195267
Udonis Haslem,2004.0,0,3,3,0.0
Udonis Haslem,2005.0,0,4,4,0.0
Udonis Haslem,2006.0,0,3,3,0.0
Udonis Haslem,2007.0,0,4,4,0.0
Udonis Haslem,2015.0,2,10,8,0.2
Udonis Haslem,2016.0,1,9,8,0.1111111111111111
Udonis Haslem,2017.0,0,3,3,0.0
Udonis Haslem,2018.0,1,8,7,0.125
Udonis Haslem,2019.0,0,12,12,0.0
Udonis Haslem,2020.0,1,3,2,0.3333333333333333
Udonis Haslem,2022.0,1,4,3,0.25
Udonis Haslem,2023.0,3,10,7,0.3
Uros Slokar,2007.0,1,2,1,0.5
Usman Garuba,2022.0,5,20,15,0.25
Usman Garuba,2023.0,24,60,36,0.4
Vander Blue,2014.0,0,1,1,0.0
Vander Blue,2015.0,2,10,8,0.2
Vander Blue,2018.0,0,2,2,0.0
Vasilije Micic,2024.0,9,36,27,0.25
Vassilis Spanoulis,2007.0,5,29,24,0.1724137931034483
Vernon Carey,2021.0,1,7,6,0.14285714285714285
Vic Law,2020.0,2,8,6,0.25
Victor Claver,2013.0,25,87,62,0.28735632183908044
Victor Claver,2014.0,3,18,15,0.16666666666666666
Victor Claver,2015.0,6,11,5,0.5454545454545454
Victor Oladipo,2014.0,74,226,152,0.3274336283185841
Victor Oladipo,2015.0,84,248,164,0.3387096774193548
Victor Oladipo,2016.0,98,282,184,0.3475177304964539
Victor Oladipo,2017.0,133,377,244,0.35278514588859416
Victor Oladipo,2018.0,184,491,307,0.37474541751527496
Victor Oladipo,2019.0,74,216,142,0.3425925925925926
Victor Oladipo,2020.0,45,137,92,0.3284671532846715
Victor Oladipo,2021.0,78,239,161,0.3263598326359833
Victor Oladipo,2022.0,32,98,66,0.32653061224489793
Victor Oladipo,2023.0,72,217,145,0.3317972350230415
Victor Wembanyama,2024.0,53,172,119,0.3081395348837209
Viktor Khryapa,2005.0,4,11,7,0.36363636363636365
Viktor Khryapa,2006.0,10,30,20,0.3333333333333333
Viktor Khryapa,2007.0,0,6,6,0.0
Viktor Khryapa,2008.0,0,1,1,0.0
Vin Baker,2004.0,1,3,2,0.3333333333333333
Vin Baker,2005.0,0,1,1,0.0
Vince Carter,2004.0,93,243,150,0.38271604938271603
Vince Carter,2005.0,133,332,199,0.4006024096385542
Vince Carter,2006.0,139,425,286,0.3270588235294118
Vince Carter,2007.0,177,491,314,0.3604887983706721
Vince Carter,2008.0,98,273,175,0.358974358974359
Vince Carter,2009.0,151,392,241,0.3852040816326531
Vince Carter,2010.0,131,375,244,0.34933333333333333
Vince Carter,2011.0,116,321,205,0.3613707165109034
Vince Carter,2012.0,77,215,138,0.3581395348837209
Vince Carter,2013.0,162,399,237,0.40601503759398494
Vince Carter,2014.0,161,402,241,0.40049751243781095
Vince Carter,2015.0,76,260,184,0.2923076923076923
Vince Carter,2016.0,66,179,113,0.3687150837988827
Vince Carter,2017.0,119,313,194,0.3801916932907348
Vince Carter,2018.0,57,165,108,0.34545454545454546
Vince Carter,2019.0,123,316,193,0.38924050632911394
Vince Carter,2020.0,61,202,141,0.30198019801980197
Vince Williams,2023.0,4,28,24,0.14285714285714285
Vince Williams,2024.0,56,144,88,0.3888888888888889
Vincent Edwards,2019.0,1,4,3,0.25
Vincent Poirier,2020.0,1,2,1,0.5
Vincent Poirier,2021.0,0,1,1,0.0
Vit Krejci ,2022.0,32,98,66,0.32653061224489793
Vit Krejci ,2023.0,5,21,16,0.23809523809523808
Vitaly Potapenko,2005.0,0,1,1,0.0
Vitor Faverani,2014.0,12,40,28,0.3
Vlade Divac,2004.0,2,13,11,0.15384615384615385
Vladimir Radmanovic,2004.0,140,377,237,0.3713527851458886
Vladimir Radmanovic,2005.0,133,350,217,0.38
Vladimir Radmanovic,2006.0,157,395,238,0.39746835443037976
Vladimir Radmanovic,2007.0,40,118,78,0.3389830508474576
Vladimir Radmanovic,2008.0,124,312,188,0.3974358974358974
Vladimir Radmanovic,2009.0,105,262,157,0.40076335877862596
Vladimir Radmanovic,2010.0,30,108,78,0.2777777777777778
Vladimir Radmanovic,2011.0,70,173,103,0.4046242774566474
Vladimir Radmanovic,2012.0,50,138,88,0.36231884057971014
Vladimir Radmanovic,2013.0,8,30,22,0.26666666666666666
Vlatko Cancar,2020.0,1,6,5,0.16666666666666666
Vlatko Cancar,2021.0,10,34,24,0.29411764705882354
Vlatko Cancar,2022.0,8,14,6,0.5714285714285714
Vlatko Cancar,2023.0,43,119,76,0.36134453781512604
Von Wafer,2006.0,2,17,15,0.11764705882352941
Von Wafer,2007.0,0,1,1,0.0
Von Wafer,2008.0,4,26,22,0.15384615384615385
Von Wafer,2009.0,73,186,113,0.3924731182795699
Von Wafer,2011.0,18,68,50,0.2647058823529412
Von Wafer,2012.0,14,39,25,0.358974358974359
Voshon Lenard,2004.0,117,313,196,0.3738019169329074
Voshon Lenard,2005.0,4,12,8,0.3333333333333333
Voshon Lenard,2006.0,25,78,53,0.32051282051282054
Wade Baldwin,2017.0,3,22,19,0.13636363636363635
Wade Baldwin,2018.0,5,6,1,0.8333333333333334
Wade Baldwin,2019.0,2,9,7,0.2222222222222222
Walker Kessler,2023.0,1,3,2,0.3333333333333333
Walker Kessler,2024.0,4,16,12,0.25
Walker Russell,2012.0,4,13,9,0.3076923076923077
Wally Szczerbiak,2004.0,30,75,45,0.4
Wally Szczerbiak,2005.0,63,169,106,0.3727810650887574
Wally Szczerbiak,2006.0,102,255,153,0.4
Wally Szczerbiak,2007.0,44,106,62,0.41509433962264153
Wally Szczerbiak,2008.0,110,280,170,0.39285714285714285
Wally Szczerbiak,2009.0,71,180,109,0.39444444444444443
Walt Lemon Jr.,2018.0,1,1,0,1.0
Walt Lemon Jr.,2019.0,2,5,3,0.4
Walter Herrmann,2007.0,53,115,62,0.4608695652173913
Walter Herrmann,2008.0,21,65,44,0.3230769230769231
Walter Herrmann,2009.0,43,124,81,0.3467741935483871
Walter McCarty,2004.0,143,380,237,0.3763157894736842
Walter McCarty,2005.0,57,161,104,0.35403726708074534
Walter McCarty,2006.0,10,46,36,0.21739130434782608
Walter Sharpe,2009.0,0,2,2,0.0
Wang Zhizhi,2004.0,4,14,10,0.2857142857142857
Wang Zhizhi,2005.0,2,3,1,0.6666666666666666
Wayne Ellington,2010.0,64,162,98,0.3950617283950617
Wayne Ellington,2011.0,48,121,73,0.39669421487603307
Wayne Ellington,2012.0,35,108,73,0.32407407407407407
Wayne Ellington,2013.0,94,240,146,0.39166666666666666
Wayne Ellington,2014.0,27,65,38,0.4153846153846154
Wayne Ellington,2015.0,90,243,153,0.37037037037037035
Wayne Ellington,2016.0,96,268,172,0.3582089552238806
Wayne Ellington,2017.0,149,394,245,0.37817258883248733
Wayne Ellington,2018.0,239,609,370,0.3924466338259442
Wayne Ellington,2019.0,145,394,249,0.3680203045685279
Wayne Ellington,2020.0,50,143,93,0.34965034965034963
Wayne Ellington,2021.0,116,275,159,0.4218181818181818
Wayne Ellington,2022.0,82,211,129,0.3886255924170616
Wayne Selden,2017.0,9,39,30,0.23076923076923078
Wayne Selden,2018.0,49,122,73,0.4016393442622951
Wayne Selden,2019.0,55,175,120,0.3142857142857143
Wayne Selden,2022.0,1,2,1,0.5
Wendell Carter,2019.0,6,32,26,0.1875
Wendell Carter,2020.0,6,29,23,0.20689655172413793
Wendell Carter,2021.0,15,51,36,0.29411764705882354
Wendell Carter,2022.0,70,214,144,0.32710280373831774
Wendell Carter,2023.0,80,226,146,0.35398230088495575
Wendell Carter,2024.0,23,53,30,0.4339622641509434
Wendell Moore,2023.0,2,17,15,0.11764705882352941
Wendell Moore,2024.0,0,2,2,0.0
Wenyen Gabriel,2020.0,9,26,17,0.34615384615384615
Wenyen Gabriel,2021.0,13,32,19,0.40625
Wenyen Gabriel,2022.0,8,28,20,0.2857142857142857
Wenyen Gabriel,2023.0,10,36,26,0.2777777777777778
Wesley Iwundu,2018.0,9,46,37,0.1956521739130435
Wesley Iwundu,2019.0,32,88,56,0.36363636363636365
Wesley Iwundu,2020.0,32,89,57,0.3595505617977528
Wesley Iwundu,2021.0,5,41,36,0.12195121951219512
Wesley Iwundu,2022.0,3,5,2,0.6
Wesley Johnson,2011.0,103,289,186,0.356401384083045
Wesley Johnson,2012.0,53,169,116,0.3136094674556213
Wesley Johnson,2013.0,50,155,105,0.3225806451612903
Wesley Johnson,2014.0,100,271,171,0.36900369003690037
Wesley Johnson,2015.0,91,259,168,0.35135135135135137
Wesley Johnson,2016.0,106,318,212,0.3333333333333333
Wesley Johnson,2017.0,29,117,88,0.24786324786324787
Wesley Johnson,2018.0,60,177,117,0.3389830508474576
Wesley Johnson,2019.0,25,76,51,0.32894736842105265
Wesley Matthews,2010.0,78,207,129,0.37681159420289856
Wesley Matthews,2011.0,162,399,237,0.40601503759398494
Wesley Matthews,2012.0,129,337,208,0.3827893175074184
Wesley Matthews,2013.0,167,420,253,0.3976190476190476
Wesley Matthews,2014.0,223,579,356,0.385146804835924
Wesley Matthews,2015.0,173,445,272,0.3887640449438202
Wesley Matthews,2016.0,199,560,361,0.35535714285714287
Wesley Matthews,2017.0,174,479,305,0.36325678496868474
Wesley Matthews,2018.0,153,402,249,0.3805970149253731
Wesley Matthews,2019.0,157,424,267,0.37028301886792453
Wesley Matthews,2020.0,125,340,215,0.36764705882352944
Wesley Matthews,2021.0,74,226,152,0.3274336283185841
Wesley Matthews,2022.0,71,202,131,0.35148514851485146
Wesley Matthews,2023.0,43,131,88,0.3282442748091603
Wesley Matthews,2024.0,6,30,24,0.2
Wesley Person,2004.0,55,138,83,0.39855072463768115
Wesley Person,2005.0,44,97,53,0.4536082474226804
Will Barton,2013.0,9,65,56,0.13846153846153847
Will Barton,2014.0,16,44,28,0.36363636363636365
Will Barton,2015.0,23,85,62,0.27058823529411763
Will Barton,2016.0,112,325,213,0.3446153846153846
Will Barton,2017.0,87,235,148,0.3702127659574468
Will Barton,2018.0,156,423,267,0.36879432624113473
Will Barton,2019.0,82,251,169,0.32669322709163345
Will Barton,2020.0,108,288,180,0.375
Will Barton,2021.0,105,278,173,0.3776978417266187
Will Barton,2022.0,168,458,290,0.36681222707423583
Will Barton,2023.0,67,180,113,0.37222222222222223
Will Blalock,2007.0,1,5,4,0.2
Will Bynum,2006.0,2,9,7,0.2222222222222222
Will Bynum,2009.0,4,23,19,0.17391304347826086
Will Bynum,2010.0,12,55,43,0.21818181818181817
Will Bynum,2011.0,16,50,34,0.32
Will Bynum,2012.0,7,29,22,0.2413793103448276
Will Bynum,2013.0,24,75,51,0.32
Will Bynum,2014.0,20,62,42,0.3225806451612903
Will Bynum,2015.0,1,11,10,0.09090909090909091
Will Cherry,2015.0,2,9,7,0.2222222222222222
Will Conroy,2010.0,0,3,3,0.0
Will Conroy,2013.0,0,3,3,0.0
Will Magnay,2021.0,0,1,1,0.0
Will Solomon,2009.0,28,86,58,0.32558139534883723
William Howard,2020.0,0,4,4,0.0
Willie Cauley-Stein,2016.0,0,2,2,0.0
Willie Cauley-Stein,2017.0,0,2,2,0.0
Willie Cauley-Stein,2018.0,3,13,10,0.23076923076923078
Willie Cauley-Stein,2019.0,1,2,1,0.5
Willie Cauley-Stein,2020.0,0,1,1,0.0
Willie Cauley-Stein,2021.0,1,11,10,0.09090909090909091
Willie Cauley-Stein,2022.0,1,2,1,0.5
Willie Green,2004.0,19,61,42,0.3114754098360656
Willie Green,2005.0,32,114,82,0.2807017543859649
Willie Green,2006.0,10,19,9,0.5263157894736842
Willie Green,2007.0,51,157,106,0.3248407643312102
Willie Green,2008.0,52,184,132,0.2826086956521739
Willie Green,2009.0,55,172,117,0.31976744186046513
Willie Green,2010.0,47,136,89,0.34558823529411764
Willie Green,2011.0,56,164,108,0.34146341463414637
Willie Green,2012.0,51,117,66,0.4358974358974359
Willie Green,2013.0,71,167,96,0.4251497005988024
Willie Green,2014.0,42,125,83,0.336
Willie Green,2015.0,42,121,79,0.34710743801652894
Willie Reed,2017.0,1,5,4,0.2
Willie Reed,2018.0,1,2,1,0.5
Willie Warren,2011.0,5,15,10,0.3333333333333333
Willy Hernangomez,2017.0,4,15,11,0.26666666666666666
Willy Hernangomez,2018.0,5,12,7,0.4166666666666667
Willy Hernangomez,2019.0,15,39,24,0.38461538461538464
Willy Hernangomez,2020.0,5,22,17,0.22727272727272727
Willy Hernangomez,2021.0,1,10,9,0.1
Willy Hernangomez,2022.0,4,13,9,0.3076923076923077
Willy Hernangomez,2023.0,3,11,8,0.2727272727272727
Wilson Chandler,2008.0,9,30,21,0.3
Wilson Chandler,2009.0,103,314,211,0.32802547770700635
Wilson Chandler,2010.0,40,150,110,0.26666666666666666
Wilson Chandler,2011.0,113,327,214,0.345565749235474
Wilson Chandler,2012.0,3,12,9,0.25
Wilson Chandler,2013.0,61,155,94,0.3935483870967742
Wilson Chandler,2014.0,122,351,229,0.3475783475783476
Wilson Chandler,2015.0,139,406,267,0.34236453201970446
Wilson Chandler,2017.0,110,326,216,0.3374233128834356
Wilson Chandler,2018.0,88,246,158,0.35772357723577236
Wilson Chandler,2019.0,60,168,108,0.35714285714285715
Wilson Chandler,2020.0,37,121,84,0.30578512396694213
Xavier Henry,2011.0,2,17,15,0.11764705882352941
Xavier Henry,2012.0,7,17,10,0.4117647058823529
Xavier Henry,2013.0,4,11,7,0.36363636363636365
Xavier Henry,2014.0,28,81,53,0.345679012345679
Xavier Moon,2022.0,5,14,9,0.35714285714285715
Xavier Moon,2023.0,1,3,2,0.3333333333333333
Xavier Moon,2024.0,0,1,1,0.0
Xavier Munford,2016.0,10,31,21,0.3225806451612903
Xavier Munford,2018.0,0,2,2,0.0
Xavier Rathan-Mayes,2018.0,1,14,13,0.07142857142857142
Xavier Silas,2012.0,1,6,5,0.16666666666666666
Xavier Silas,2018.0,0,2,2,0.0
Xavier Sneed,2022.0,1,8,7,0.125
Xavier Sneed,2023.0,3,6,3,0.5
Xavier Tillman,2021.0,24,69,45,0.34782608695652173
Xavier Tillman,2022.0,11,51,40,0.21568627450980393
Xavier Tillman,2023.0,5,19,14,0.2631578947368421
Xavier Tillman,2024.0,12,52,40,0.23076923076923078
Yakhouba Diawara,2007.0,49,170,121,0.28823529411764703
Yakhouba Diawara,2008.0,21,68,47,0.3088235294117647
Yakhouba Diawara,2009.0,51,164,113,0.31097560975609756
Yakhouba Diawara,2010.0,1,6,5,0.16666666666666666
Yante Maten,2019.0,0,1,1,0.0
Yao Ming,2004.0,0,2,2,0.0
Yao Ming,2006.0,0,1,1,0.0
Yao Ming,2007.0,0,2,2,0.0
Yao Ming,2008.0,0,2,2,0.0
Yao Ming,2009.0,1,1,0,1.0
Yaroslav Korolev,2006.0,2,7,5,0.2857142857142857
Yaroslav Korolev,2007.0,1,5,4,0.2
Yi Jianlian,2008.0,6,21,15,0.2857142857142857
Yi Jianlian,2009.0,48,140,92,0.34285714285714286
Yi Jianlian,2010.0,15,41,26,0.36585365853658536
Yi Jianlian,2011.0,3,13,10,0.23076923076923078
Yi Jianlian,2012.0,3,11,8,0.2727272727272727
Yogi Ferrell,2017.0,68,177,109,0.384180790960452
Yogi Ferrell,2018.0,134,359,225,0.3732590529247911
Yogi Ferrell,2019.0,54,149,95,0.3624161073825503
Yogi Ferrell,2020.0,24,79,55,0.3037974683544304
Yogi Ferrell,2021.0,9,29,20,0.3103448275862069
Yuta Tabuse,2005.0,1,1,0,1.0
Yuta Watanabe,2019.0,2,16,14,0.125
Yuta Watanabe,2020.0,3,8,5,0.375
Yuta Watanabe,2021.0,36,90,54,0.4
Yuta Watanabe,2022.0,27,80,53,0.3375
Yuta Watanabe,2023.0,61,137,76,0.44525547445255476
Yuta Watanabe,2024.0,23,73,50,0.3150684931506849
Yves Pons,2022.0,3,9,6,0.3333333333333333
Zabian Dowdell,2011.0,3,10,7,0.3
Zach Collins,2018.0,38,127,89,0.2992125984251969
Zach Collins,2019.0,47,142,95,0.33098591549295775
Zach Collins,2020.0,8,21,13,0.38095238095238093
Zach Collins,2022.0,14,42,28,0.3333333333333333
Zach Collins,2023.0,55,147,92,0.3741496598639456
Zach Collins,2024.0,36,124,88,0.2903225806451613
Zach LaVine,2015.0,57,167,110,0.3413173652694611
Zach LaVine,2016.0,123,316,193,0.38924050632911394
Zach LaVine,2017.0,120,309,189,0.3883495145631068
Zach LaVine,2018.0,42,123,81,0.34146341463414637
Zach LaVine,2019.0,120,321,201,0.37383177570093457
Zach LaVine,2020.0,184,484,300,0.38016528925619836
Zach LaVine,2021.0,200,477,277,0.4192872117400419
Zach LaVine,2022.0,194,499,305,0.38877755511022044
Zach LaVine,2023.0,204,544,340,0.375
Zach LaVine,2024.0,59,169,110,0.34911242603550297
Zach Lofton,2019.0,0,1,1,0.0
Zach Norvell,2020.0,3,8,5,0.375
Zach Randolph,2004.0,1,5,4,0.2
Zach Randolph,2005.0,0,6,6,0.0
Zach Randolph,2006.0,16,55,39,0.2909090909090909
Zach Randolph,2007.0,14,48,34,0.2916666666666667
Zach Randolph,2008.0,22,80,58,0.275
Zach Randolph,2009.0,32,97,65,0.32989690721649484
Zach Randolph,2010.0,15,52,37,0.28846153846153844
Zach Randolph,2011.0,10,51,41,0.19607843137254902
Zach Randolph,2012.0,2,12,10,0.16666666666666666
Zach Randolph,2013.0,2,24,22,0.08333333333333333
Zach Randolph,2014.0,2,21,19,0.09523809523809523
Zach Randolph,2015.0,8,25,17,0.32
Zach Randolph,2016.0,6,26,20,0.23076923076923078
Zach Randolph,2017.0,22,101,79,0.21782178217821782
Zach Randolph,2018.0,51,147,96,0.3469387755102041
Zarko Cabarkapa,2004.0,6,32,26,0.1875
Zarko Cabarkapa,2005.0,13,36,23,0.3611111111111111
Zarko Cabarkapa,2006.0,5,20,15,0.25
Zavier Simpson,2022.0,1,8,7,0.125
Zaza Pachulia,2005.0,0,1,1,0.0
Zaza Pachulia,2006.0,0,2,2,0.0
Zaza Pachulia,2007.0,0,1,1,0.0
Zaza Pachulia,2008.0,0,4,4,0.0
Zaza Pachulia,2009.0,0,3,3,0.0
Zaza Pachulia,2010.0,0,4,4,0.0
Zaza Pachulia,2013.0,0,3,3,0.0
Zaza Pachulia,2014.0,0,1,1,0.0
Zaza Pachulia,2015.0,0,3,3,0.0
Zaza Pachulia,2016.0,0,3,3,0.0
Zaza Pachulia,2017.0,0,2,2,0.0
Zaza Pachulia,2018.0,0,1,1,0.0
Zaza Pachulia,2019.0,0,4,4,0.0
Zeke Nnaji,2021.0,27,66,39,0.4090909090909091
Zeke Nnaji,2022.0,38,81,43,0.4691358024691358
Zeke Nnaji,2023.0,18,68,50,0.2647058823529412
Zeke Nnaji,2024.0,5,16,11,0.3125
Zhaire Smith,2019.0,6,16,10,0.375
Zhaire Smith,2020.0,0,3,3,0.0
Zhou Qi,2018.0,2,19,17,0.10526315789473684
Ziaire Williams,2022.0,87,278,191,0.3129496402877698
Ziaire Williams,2023.0,26,100,74,0.26
Ziaire Williams,2024.0,49,156,107,0.3141025641025641
Zion Williamson,2020.0,6,14,8,0.42857142857142855
Zion Williamson,2021.0,10,34,24,0.29411764705882354
Zion Williamson,2023.0,7,19,12,0.3684210526315789
Zion Williamson,2024.0,4,10,6,0.4
Zoran Dragic,2015.0,3,14,11,0.21428571428571427
Zoran Planinic,2004.0,9,33,24,0.2727272727272727
Zoran Planinic,2005.0,15,40,25,0.375
Zoran Planinic,2006.0,13,56,43,0.23214285714285715
Zydrunas Ilgauskas,2004.0,2,7,5,0.2857142857142857
Zydrunas Ilgauskas,2005.0,2,7,5,0.2857142857142857
Zydrunas Ilgauskas,2006.0,0,5,5,0.0
Zydrunas Ilgauskas,2007.0,0,1,1,0.0
Zydrunas Ilgauskas,2008.0,0,1,1,0.0
Zydrunas Ilgauskas,2009.0,17,52,35,0.3269230769230769
Zydrunas Ilgauskas,2010.0,11,23,12,0.4782608695652174
Zydrunas Ilgauskas,2011.0,0,1,1,0.0
Zylan Cheatham,2020.0,0,1,1,0.0
Zylan Cheatham,2022.0,0,2,2,0.0
